"ID";"RegioS";"Perioden";"WoningvoorraadBeginPeriode_1";"WoningvoorraadToevoegingTotaal_2";"WoningvoorraadToevoegingDoorNieuwbouw_3";"WoningvoorraadToevoegingAnderszins_4";"WoningvoorraadSaldoVermeerdering_14";"WoningvoorraadAdministratieveCorrectie_15";"WoningvoorraadEindePeriode_16"
"425";"PV20  ";"1995KW01";"234239";"400";"350";"50";"259";"0";"234498"
"426";"PV20  ";"1995KW02";"234498";"648";"624";"24";"500";"0";"234998"
"427";"PV20  ";"1995KW03";"234998";"643";"581";"62";"410";"0";"235408"
"428";"PV20  ";"1995KW04";"235408";"1504";"1406";"98";"1127";"-8";"236527"
"429";"PV20  ";"1995JJ00";"234239";"3195";"2961";"234";"2296";"-8";"236527"
"430";"PV20  ";"1996KW01";"236527";"227";"190";"37";"105";"0";"236632"
"431";"PV20  ";"1996KW02";"236632";"752";"667";"85";"475";"0";"237107"
"432";"PV20  ";"1996KW03";"237107";"957";"936";"21";"750";"0";"237857"
"433";"PV20  ";"1996KW04";"237857";"1198";"1111";"87";"901";"-72";"238686"
"434";"PV20  ";"1996JJ00";"236527";"3134";"2904";"230";"2231";"-72";"238686"
"435";"PV20  ";"1997KW01";"238686";"697";"677";"20";"604";"0";"239290"
"436";"PV20  ";"1997KW02";"239290";"775";"731";"44";"732";"0";"240022"
"437";"PV20  ";"1997KW03";"240022";"505";"438";"67";"432";"0";"240454"
"438";"PV20  ";"1997KW04";"240454";"1256";"1199";"57";"874";"-74";"241254"
"439";"PV20  ";"1997JJ00";"238686";"3233";"3045";"188";"2642";"-74";"241254"
"440";"PV20  ";"1998KW01";"241270";"543";"543";"0";"218";"0";"241488"
"441";"PV20  ";"1998KW02";"241488";"667";"646";"21";"368";"0";"241856"
"442";"PV20  ";"1998KW03";"241856";"596";"574";"22";"451";"0";"242307"
"443";"PV20  ";"1998KW04";"242307";"1133";"1044";"89";"805";"-65";"243047"
"444";"PV20  ";"1998JJ00";"241270";"2939";"2807";"132";"1842";"-65";"243047"
"445";"PV20  ";"1999KW01";"243047";"325";"289";"36";"158";"0";"243205"
"446";"PV20  ";"1999KW02";"243205";"434";"425";"9";"62";"0";"243267"
"447";"PV20  ";"1999KW03";"243267";"564";"540";"24";"37";"0";"243304"
"448";"PV20  ";"1999KW04";"243304";"1214";"1114";"100";"755";"-116";"243943"
"449";"PV20  ";"1999JJ00";"243047";"2537";"2368";"169";"1012";"-116";"243943"
"450";"PV20  ";"2000KW01";"243943";"253";"228";"25";"125";"0";"244068"
"451";"PV20  ";"2000KW02";"244068";"350";"345";"5";"238";"0";"244306"
"452";"PV20  ";"2000KW03";"244306";"425";"421";"4";"212";"0";"244518"
"453";"PV20  ";"2000KW04";"244518";"780";"775";"5";"325";"-638";"244205"
"454";"PV20  ";"2000JJ00";"243943";"1808";"1769";"39";"900";"-638";"244205"
"455";"PV20  ";"2001KW01";"244205";"272";"185";"87";"-517";"0";"243688"
"456";"PV20  ";"2001KW02";"243688";"757";"754";"3";"606";"0";"244294"
"457";"PV20  ";"2001KW03";"244294";"533";"533";"0";"415";"0";"244709"
"458";"PV20  ";"2001KW04";"244709";"735";"699";"36";"-310";"482";"244881"
"459";"PV20  ";"2001JJ00";"244205";"2297";"2171";"126";"194";"482";"244881"
"460";"PV20  ";"2002KW01";"244881";"320";"299";"21";"-168";"0";"244713"
"461";"PV20  ";"2002KW02";"244713";"427";"382";"45";"214";"0";"244927"
"462";"PV20  ";"2002KW03";"244927";"722";"715";"7";"619";"0";"245546"
"463";"PV20  ";"2002KW04";"245546";"1185";"1037";"148";"734";"167";"246447"
"464";"PV20  ";"2002JJ00";"244881";"2654";"2433";"221";"1399";"167";"246447"
"465";"PV20  ";"2003KW01";"246447";"435";"386";"49";"146";"0";"246593"
"466";"PV20  ";"2003KW02";"246593";"584";"473";"111";"206";"0";"246799"
"467";"PV20  ";"2003KW03";"246799";"320";"316";"4";"187";"0";"246986"
"468";"PV20  ";"2003KW04";"246986";"671";"618";"53";"349";"-102";"247233"
"469";"PV20  ";"2003JJ00";"246447";"2010";"1793";"217";"888";"-102";"247233"
"470";"PV20  ";"2004KW01";"247233";"153";"149";"4";"29";"0";"247262"
"471";"PV20  ";"2004KW02";"247262";"387";"374";"13";"62";"0";"247324"
"472";"PV20  ";"2004KW03";"247324";"455";"430";"25";"198";"0";"247522"
"473";"PV20  ";"2004KW04";"247522";"610";"587";"23";"55";"-94";"247483"
"474";"PV20  ";"2004JJ00";"247233";"1605";"1540";"65";"344";"-94";"247483"
"475";"PV20  ";"2005KW01";"247483";"257";"253";"4";"-86";"0";"247397"
"476";"PV20  ";"2005KW02";"247397";"183";"177";"6";"-184";"0";"247213"
"477";"PV20  ";"2005KW03";"247213";"466";"364";"102";"-254";"0";"246959"
"478";"PV20  ";"2005KW04";"246959";"1281";"1247";"34";"821";"-45";"247735"
"479";"PV20  ";"2005JJ00";"247483";"2187";"2041";"146";"297";"-45";"247735"
"480";"PV20  ";"2006KW01";"247735";"257";"232";"25";"68";"0";"247803"
"481";"PV20  ";"2006KW02";"247803";"457";"437";"20";"15";"0";"247818"
"482";"PV20  ";"2006KW03";"247818";"446";"408";"38";"158";"0";"247976"
"483";"PV20  ";"2006KW04";"247976";"1201";"1089";"112";"435";"-40";"248371"
"484";"PV20  ";"2006JJ00";"247735";"2361";"2166";"195";"676";"-40";"248371"
"485";"PV20  ";"2007KW01";"248371";"308";"278";"30";"44";"0";"248415"
"486";"PV20  ";"2007KW02";"248415";"366";"354";"12";"145";"0";"248560"
"487";"PV20  ";"2007KW03";"248560";"660";"648";"12";"241";"0";"248801"
"488";"PV20  ";"2007KW04";"248801";"1178";"867";"311";"791";"-8";"249584"
"489";"PV20  ";"2007JJ00";"248371";"2512";"2147";"365";"1221";"-8";"249584"
"490";"PV20  ";"2008KW01";"250383";"301";"298";"3";"171";"0";"250554"
"491";"PV20  ";"2008KW02";"250554";"557";"550";"7";"217";"0";"250771"
"492";"PV20  ";"2008KW03";"250771";"878";"804";"74";"460";"0";"251231"
"493";"PV20  ";"2008KW04";"251231";"1398";"1332";"66";"1003";"-92";"252142"
"494";"PV20  ";"2008JJ00";"250383";"3134";"2984";"150";"1851";"-92";"252142"
"495";"PV20  ";"2009KW01";"252142";"458";"450";"8";"252";"0";"252394"
"496";"PV20  ";"2009KW02";"252394";"532";"475";"57";"399";"0";"252793"
"497";"PV20  ";"2009KW03";"252793";"518";"502";"16";"424";"0";"253217"
"498";"PV20  ";"2009KW04";"253217";"1342";"1282";"60";"726";"41";"253984"
"499";"PV20  ";"2009JJ00";"252142";"2850";"2709";"141";"1801";"41";"253984"
"500";"PV20  ";"2010KW01";"253984";"135";"124";"11";"-138";"0";"253846"
"501";"PV20  ";"2010KW02";"253846";"371";"337";"34";"228";"0";"254074"
"502";"PV20  ";"2010KW03";"254074";"198";"192";"6";"47";"0";"254121"
"503";"PV20  ";"2010KW04";"254121";"934";"886";"48";"587";"-31";"254677"
"504";"PV20  ";"2010JJ00";"253984";"1638";"1539";"99";"724";"-31";"254677"
"505";"PV20  ";"2011KW01";"254677";"392";"163";"229";"57";"0";"254734"
"506";"PV20  ";"2011KW02";"254734";"829";"715";"114";"634";"0";"255368"
"507";"PV20  ";"2011KW03";"255368";"281";"251";"30";"204";"0";"255572"
"508";"PV20  ";"2011KW04";"255572";"852";"754";"98";"626";"-241";"255957"
"509";"PV20  ";"2011JJ00";"254677";"2354";"1883";"471";"1521";"-241";"255957"
"510";"PV21  ";"1995KW01";"247030";"900";"838";"62";"672";"0";"247702"
"511";"PV21  ";"1995KW02";"247702";"811";"774";"37";"713";"0";"248415"
"512";"PV21  ";"1995KW03";"248415";"810";"772";"38";"639";"0";"249054"
"513";"PV21  ";"1995KW04";"249054";"1563";"1396";"167";"1374";"-95";"250333"
"514";"PV21  ";"1995JJ00";"247030";"4084";"3780";"304";"3398";"-95";"250333"
"515";"PV21  ";"1996KW01";"250333";"479";"466";"13";"402";"0";"250735"
"516";"PV21  ";"1996KW02";"250735";"743";"694";"49";"633";"0";"251368"
"517";"PV21  ";"1996KW03";"251368";"805";"786";"19";"713";"0";"252081"
"518";"PV21  ";"1996KW04";"252081";"1192";"1131";"61";"1031";"21";"253133"
"519";"PV21  ";"1996JJ00";"250333";"3219";"3077";"142";"2779";"21";"253133"
"520";"PV21  ";"1997KW01";"253133";"583";"550";"33";"442";"0";"253575"
"521";"PV21  ";"1997KW02";"253575";"830";"813";"17";"651";"0";"254226"
"522";"PV21  ";"1997KW03";"254226";"946";"926";"20";"896";"0";"255122"
"523";"PV21  ";"1997KW04";"255122";"1415";"1302";"113";"1250";"-28";"256344"
"524";"PV21  ";"1997JJ00";"253133";"3774";"3591";"183";"3239";"-28";"256344"
"525";"PV21  ";"1998KW01";"256345";"569";"548";"21";"516";"0";"256861"
"526";"PV21  ";"1998KW02";"256861";"886";"858";"28";"798";"0";"257659"
"527";"PV21  ";"1998KW03";"257659";"683";"677";"6";"602";"0";"258261"
"528";"PV21  ";"1998KW04";"258261";"1428";"1234";"194";"1274";"-41";"259494"
"529";"PV21  ";"1998JJ00";"256345";"3566";"3317";"249";"3190";"-41";"259494"
"530";"PV21  ";"1999KW01";"259494";"375";"365";"10";"315";"0";"259809"
"531";"PV21  ";"1999KW02";"259809";"723";"694";"29";"465";"0";"260274"
"532";"PV21  ";"1999KW03";"260274";"870";"833";"37";"688";"0";"260962"
"533";"PV21  ";"1999KW04";"260962";"1300";"1182";"118";"1008";"-121";"261849"
"534";"PV21  ";"1999JJ00";"259494";"3268";"3074";"194";"2476";"-121";"261849"
"535";"PV21  ";"2000KW01";"261849";"328";"309";"19";"225";"0";"262074"
"536";"PV21  ";"2000KW02";"262074";"557";"544";"13";"488";"0";"262562"
"537";"PV21  ";"2000KW03";"262562";"515";"510";"5";"455";"0";"263017"
"538";"PV21  ";"2000KW04";"263017";"1208";"1140";"68";"1053";"45";"264115"
"539";"PV21  ";"2000JJ00";"261849";"2608";"2503";"105";"2221";"45";"264115"
"540";"PV21  ";"2001KW01";"264115";"352";"335";"17";"244";"0";"264359"
"541";"PV21  ";"2001KW02";"264359";"674";"664";"10";"560";"0";"264919"
"542";"PV21  ";"2001KW03";"264919";"595";"585";"10";"508";"0";"265427"
"543";"PV21  ";"2001KW04";"265427";"1143";"1117";"26";"880";"38";"266345"
"544";"PV21  ";"2001JJ00";"264115";"2764";"2701";"63";"2192";"38";"266345"
"545";"PV21  ";"2002KW01";"266345";"310";"297";"13";"275";"0";"266620"
"546";"PV21  ";"2002KW02";"266620";"465";"451";"14";"316";"0";"266936"
"547";"PV21  ";"2002KW03";"266936";"417";"409";"8";"332";"0";"267268"
"548";"PV21  ";"2002KW04";"267268";"1245";"1142";"103";"975";"-43";"268200"
"549";"PV21  ";"2002JJ00";"266345";"2437";"2299";"138";"1898";"-43";"268200"
"550";"PV21  ";"2003KW01";"268200";"321";"286";"35";"92";"0";"268292"
"551";"PV21  ";"2003KW02";"268292";"526";"491";"35";"386";"0";"268678"
"552";"PV21  ";"2003KW03";"268678";"530";"517";"13";"345";"0";"269023"
"553";"PV21  ";"2003KW04";"269023";"576";"545";"31";"351";"4";"269378"
"554";"PV21  ";"2003JJ00";"268200";"1953";"1839";"114";"1174";"4";"269378"
"555";"PV21  ";"2004KW01";"269378";"298";"284";"14";"187";"0";"269565"
"556";"PV21  ";"2004KW02";"269565";"304";"276";"28";"86";"0";"269651"
"557";"PV21  ";"2004KW03";"269651";"485";"448";"37";"222";"0";"269873"
"558";"PV21  ";"2004KW04";"269873";"2072";"2002";"70";"1852";"-225";"271500"
"559";"PV21  ";"2004JJ00";"269378";"3159";"3010";"149";"2347";"-225";"271500"
"560";"PV21  ";"2005KW01";"271500";"376";"350";"26";"236";"0";"271736"
"561";"PV21  ";"2005KW02";"271736";"488";"464";"24";"325";"0";"272061"
"562";"PV21  ";"2005KW03";"272061";"513";"447";"66";"352";"0";"272413"
"563";"PV21  ";"2005KW04";"272413";"1163";"1126";"37";"977";"5";"273395"
"564";"PV21  ";"2005JJ00";"271500";"2540";"2387";"153";"1890";"5";"273395"
"565";"PV21  ";"2006KW01";"273395";"513";"498";"15";"458";"0";"273853"
"566";"PV21  ";"2006KW02";"273853";"435";"404";"31";"306";"0";"274159"
"567";"PV21  ";"2006KW03";"274159";"504";"482";"22";"431";"0";"274590"
"568";"PV21  ";"2006KW04";"274590";"1410";"1348";"62";"1075";"-444";"275221"
"569";"PV21  ";"2006JJ00";"273395";"2862";"2732";"130";"2270";"-444";"275221"
"570";"PV21  ";"2007KW01";"275221";"375";"335";"40";"250";"0";"275471"
"571";"PV21  ";"2007KW02";"275471";"736";"695";"41";"502";"0";"275973"
"572";"PV21  ";"2007KW03";"275973";"499";"478";"21";"460";"0";"276433"
"573";"PV21  ";"2007KW04";"276433";"1300";"1264";"36";"1054";"-124";"277363"
"574";"PV21  ";"2007JJ00";"275221";"2910";"2772";"138";"2266";"-124";"277363"
"575";"PV21  ";"2008KW01";"277959";"531";"505";"26";"369";"0";"278328"
"576";"PV21  ";"2008KW02";"278328";"548";"515";"33";"471";"0";"278799"
"577";"PV21  ";"2008KW03";"278799";"932";"901";"31";"843";"0";"279642"
"578";"PV21  ";"2008KW04";"279642";"977";"944";"33";"819";"-105";"280356"
"579";"PV21  ";"2008JJ00";"277959";"2988";"2865";"123";"2502";"-105";"280356"
"580";"PV21  ";"2009KW01";"280356";"389";"369";"20";"204";"0";"280560"
"581";"PV21  ";"2009KW02";"280560";"478";"418";"60";"378";"0";"280938"
"582";"PV21  ";"2009KW03";"280938";"282";"266";"16";"187";"0";"281125"
"583";"PV21  ";"2009KW04";"281125";"920";"887";"33";"627";"-120";"281632"
"584";"PV21  ";"2009JJ00";"280356";"2069";"1940";"129";"1396";"-120";"281632"
"585";"PV21  ";"2010KW01";"281632";"159";"140";"19";"102";"0";"281734"
"586";"PV21  ";"2010KW02";"281734";"228";"162";"66";"163";"0";"281897"
"587";"PV21  ";"2010KW03";"281897";"305";"291";"14";"192";"0";"282089"
"588";"PV21  ";"2010KW04";"282089";"1034";"974";"60";"741";"-141";"282689"
"589";"PV21  ";"2010JJ00";"281632";"1726";"1567";"159";"1198";"-141";"282689"
"590";"PV21  ";"2011KW01";"282689";"197";"190";"7";"94";"0";"282783"
"591";"PV21  ";"2011KW02";"282783";"342";"298";"44";"151";"0";"282934"
"592";"PV21  ";"2011KW03";"282934";"302";"258";"44";"160";"0";"283094"
"593";"PV21  ";"2011KW04";"283094";"894";"769";"125";"841";"98";"284033"
"594";"PV21  ";"2011JJ00";"282689";"1735";"1515";"220";"1246";"98";"284033"
"595";"PV22  ";"1995KW01";"179505";"638";"632";"6";"533";"0";"180038"
"596";"PV22  ";"1995KW02";"180038";"673";"663";"10";"645";"0";"180683"
"597";"PV22  ";"1995KW03";"180683";"604";"591";"13";"459";"0";"181142"
"598";"PV22  ";"1995KW04";"181142";"1236";"1203";"33";"1174";"-50";"182266"
"599";"PV22  ";"1995JJ00";"179505";"3151";"3089";"62";"2811";"-50";"182266"
"600";"PV22  ";"1996KW01";"182266";"260";"258";"2";"229";"0";"182495"
"601";"PV22  ";"1996KW02";"182495";"711";"703";"8";"584";"0";"183079"
"602";"PV22  ";"1996KW03";"183079";"975";"968";"7";"863";"0";"183942"
"603";"PV22  ";"1996KW04";"183942";"1082";"1065";"17";"1026";"-50";"184918"
"604";"PV22  ";"1996JJ00";"182266";"3028";"2994";"34";"2702";"-50";"184918"
"605";"PV22  ";"1997KW01";"184923";"459";"436";"23";"385";"0";"185308"
"606";"PV22  ";"1997KW02";"185308";"956";"953";"3";"926";"0";"186234"
"607";"PV22  ";"1997KW03";"186234";"635";"633";"2";"549";"0";"186783"
"608";"PV22  ";"1997KW04";"186783";"1142";"1130";"12";"1070";"2";"187855"
"609";"PV22  ";"1997JJ00";"184923";"3192";"3152";"40";"2930";"2";"187855"
"610";"PV22  ";"1998KW01";"187838";"297";"290";"7";"228";"0";"188066"
"611";"PV22  ";"1998KW02";"188066";"378";"374";"4";"357";"0";"188423"
"612";"PV22  ";"1998KW03";"188423";"494";"487";"7";"438";"0";"188861"
"613";"PV22  ";"1998KW04";"188861";"963";"950";"13";"640";"150";"189651"
"614";"PV22  ";"1998JJ00";"187838";"2132";"2101";"31";"1663";"150";"189651"
"615";"PV22  ";"1999KW01";"189651";"626";"622";"4";"603";"0";"190254"
"616";"PV22  ";"1999KW02";"190254";"600";"598";"2";"537";"0";"190791"
"617";"PV22  ";"1999KW03";"190791";"331";"328";"3";"319";"0";"191110"
"618";"PV22  ";"1999KW04";"191110";"1084";"1065";"19";"749";"-234";"191625"
"619";"PV22  ";"1999JJ00";"189651";"2641";"2613";"28";"2208";"-234";"191625"
"620";"PV22  ";"2000KW01";"191625";"249";"248";"1";"145";"0";"191770"
"621";"PV22  ";"2000KW02";"191770";"508";"499";"9";"431";"0";"192201"
"622";"PV22  ";"2000KW03";"192201";"366";"365";"1";"338";"0";"192539"
"623";"PV22  ";"2000KW04";"192539";"939";"931";"8";"745";"8";"193292"
"624";"PV22  ";"2000JJ00";"191625";"2062";"2043";"19";"1659";"8";"193292"
"625";"PV22  ";"2001KW01";"193292";"434";"433";"1";"110";"0";"193402"
"626";"PV22  ";"2001KW02";"193402";"431";"427";"4";"236";"0";"193638"
"627";"PV22  ";"2001KW03";"193638";"497";"489";"8";"415";"0";"194053"
"628";"PV22  ";"2001KW04";"194053";"630";"625";"5";"469";"-114";"194408"
"629";"PV22  ";"2001JJ00";"193292";"1992";"1974";"18";"1230";"-114";"194408"
"630";"PV22  ";"2002KW01";"194408";"165";"162";"3";"111";"0";"194519"
"631";"PV22  ";"2002KW02";"194519";"196";"196";"0";"157";"0";"194676"
"632";"PV22  ";"2002KW03";"194676";"224";"214";"10";"193";"0";"194869"
"633";"PV22  ";"2002KW04";"194869";"1747";"1736";"11";"1385";"-163";"196091"
"634";"PV22  ";"2002JJ00";"194408";"2332";"2308";"24";"1846";"-163";"196091"
"635";"PV22  ";"2003KW01";"196091";"155";"155";"0";"13";"0";"196104"
"636";"PV22  ";"2003KW02";"196104";"279";"277";"2";"247";"0";"196351"
"637";"PV22  ";"2003KW03";"196351";"312";"311";"1";"258";"0";"196609"
"638";"PV22  ";"2003KW04";"196609";"1086";"986";"100";"984";"-166";"197427"
"639";"PV22  ";"2003JJ00";"196091";"1832";"1729";"103";"1502";"-166";"197427"
"640";"PV22  ";"2004KW01";"197427";"326";"318";"8";"235";"0";"197662"
"641";"PV22  ";"2004KW02";"197662";"266";"259";"7";"238";"0";"197900"
"642";"PV22  ";"2004KW03";"197900";"749";"746";"3";"683";"0";"198583"
"643";"PV22  ";"2004KW04";"198583";"913";"870";"43";"619";"-126";"199076"
"644";"PV22  ";"2004JJ00";"197427";"2254";"2193";"61";"1775";"-126";"199076"
"645";"PV22  ";"2005KW01";"199076";"256";"228";"28";"165";"0";"199241"
"646";"PV22  ";"2005KW02";"199241";"512";"502";"10";"472";"0";"199713"
"647";"PV22  ";"2005KW03";"199713";"287";"283";"4";"241";"0";"199954"
"648";"PV22  ";"2005KW04";"199954";"1067";"1064";"3";"969";"-194";"200729"
"649";"PV22  ";"2005JJ00";"199076";"2122";"2077";"45";"1847";"-194";"200729"
"650";"PV22  ";"2006KW01";"200729";"383";"376";"7";"189";"0";"200918"
"651";"PV22  ";"2006KW02";"200918";"348";"342";"6";"337";"0";"201255"
"652";"PV22  ";"2006KW03";"201255";"542";"531";"11";"429";"0";"201684"
"653";"PV22  ";"2006KW04";"201684";"1053";"1017";"36";"986";"-71";"202599"
"654";"PV22  ";"2006JJ00";"200729";"2326";"2266";"60";"1941";"-71";"202599"
"655";"PV22  ";"2007KW01";"202599";"341";"341";"0";"119";"0";"202718"
"656";"PV22  ";"2007KW02";"202718";"581";"566";"15";"563";"0";"203281"
"657";"PV22  ";"2007KW03";"203281";"462";"446";"16";"418";"0";"203699"
"658";"PV22  ";"2007KW04";"203699";"1450";"1440";"10";"1268";"-203";"204764"
"659";"PV22  ";"2007JJ00";"202599";"2834";"2793";"41";"2368";"-203";"204764"
"660";"PV22  ";"2008KW01";"204866";"290";"289";"1";"207";"0";"205073"
"661";"PV22  ";"2008KW02";"205073";"286";"284";"2";"244";"0";"205317"
"662";"PV22  ";"2008KW03";"205317";"534";"532";"2";"441";"0";"205758"
"663";"PV22  ";"2008KW04";"205758";"914";"901";"13";"769";"-196";"206331"
"664";"PV22  ";"2008JJ00";"204866";"2024";"2006";"18";"1661";"-196";"206331"
"665";"PV22  ";"2009KW01";"206331";"212";"200";"12";"200";"0";"206531"
"666";"PV22  ";"2009KW02";"206531";"326";"326";"0";"296";"0";"206827"
"667";"PV22  ";"2009KW03";"206827";"364";"364";"0";"315";"0";"207142"
"668";"PV22  ";"2009KW04";"207142";"936";"933";"3";"844";"-99";"207887"
"669";"PV22  ";"2009JJ00";"206331";"1838";"1823";"15";"1655";"-99";"207887"
"670";"PV22  ";"2010KW01";"207887";"112";"110";"2";"75";"0";"207962"
"671";"PV22  ";"2010KW02";"207962";"72";"70";"2";"56";"0";"208018"
"672";"PV22  ";"2010KW03";"208018";"167";"163";"4";"147";"0";"208165"
"673";"PV22  ";"2010KW04";"208165";"651";"644";"7";"518";"-221";"208462"
"674";"PV22  ";"2010JJ00";"207887";"1002";"987";"15";"796";"-221";"208462"
"675";"PV22  ";"2011KW01";"208462";"122";"121";"1";"113";"0";"208575"
"676";"PV22  ";"2011KW02";"208575";"120";"116";"4";"92";"0";"208667"
"677";"PV22  ";"2011KW03";"208667";"152";"151";"1";"138";"0";"208805"
"678";"PV22  ";"2011KW04";"208805";"395";"387";"8";"146";"-40";"208912"
"679";"PV22  ";"2011JJ00";"208462";"789";"775";"14";"489";"-40";"208911"
"680";"PV23  ";"1995KW01";"394763";"849";"831";"18";"669";"0";"395432"
"681";"PV23  ";"1995KW02";"395432";"1301";"1283";"18";"1132";"0";"396564"
"682";"PV23  ";"1995KW03";"396564";"2078";"2057";"21";"2014";"0";"398578"
"683";"PV23  ";"1995KW04";"398578";"3001";"2957";"44";"2751";"-42";"401287"
"684";"PV23  ";"1995JJ00";"394763";"7229";"7128";"101";"6566";"-42";"401287"
"685";"PV23  ";"1996KW01";"401287";"621";"610";"11";"572";"0";"401859"
"686";"PV23  ";"1996KW02";"401859";"1607";"1587";"20";"1373";"0";"403232"
"687";"PV23  ";"1996KW03";"403232";"1854";"1803";"51";"1436";"0";"404668"
"688";"PV23  ";"1996KW04";"404668";"3134";"3037";"97";"2759";"-117";"407310"
"689";"PV23  ";"1996JJ00";"401287";"7216";"7037";"179";"6140";"-117";"407310"
"690";"PV23  ";"1997KW01";"407305";"757";"733";"24";"690";"0";"407995"
"691";"PV23  ";"1997KW02";"407995";"1546";"1503";"43";"1424";"0";"409419"
"692";"PV23  ";"1997KW03";"409419";"1636";"1602";"34";"1563";"0";"410982"
"693";"PV23  ";"1997KW04";"410982";"3528";"3350";"178";"2954";"-1";"413935"
"694";"PV23  ";"1997JJ00";"407305";"7467";"7188";"279";"6631";"-1";"413935"
"695";"PV23  ";"1998KW01";"413935";"816";"799";"17";"771";"0";"414706"
"696";"PV23  ";"1998KW02";"414706";"1172";"1121";"51";"1057";"0";"415763"
"697";"PV23  ";"1998KW03";"415763";"1265";"1253";"12";"1129";"0";"416892"
"698";"PV23  ";"1998KW04";"416892";"3388";"3329";"59";"2993";"240";"420125"
"699";"PV23  ";"1998JJ00";"413935";"6641";"6502";"139";"5950";"240";"420125"
"700";"PV23  ";"1999KW01";"420125";"934";"870";"64";"676";"0";"420801"
"701";"PV23  ";"1999KW02";"420801";"1101";"1061";"40";"897";"0";"421698"
"702";"PV23  ";"1999KW03";"421698";"938";"923";"15";"822";"0";"422520"
"703";"PV23  ";"1999KW04";"422520";"3183";"3105";"78";"2848";"-424";"424944"
"704";"PV23  ";"1999JJ00";"420125";"6156";"5959";"197";"5243";"-424";"424944"
"705";"PV23  ";"2000KW01";"424969";"567";"510";"57";"366";"0";"425335"
"706";"PV23  ";"2000KW02";"425335";"653";"637";"16";"553";"0";"425888"
"707";"PV23  ";"2000KW03";"425888";"1284";"1232";"52";"1133";"0";"427021"
"708";"PV23  ";"2000KW04";"427021";"1958";"1928";"30";"1644";"-42";"428623"
"709";"PV23  ";"2000JJ00";"424969";"4462";"4307";"155";"3696";"-42";"428623"
"710";"PV23  ";"2001KW01";"428623";"860";"830";"30";"676";"0";"429299"
"711";"PV23  ";"2001KW02";"429299";"674";"658";"16";"559";"0";"429858"
"712";"PV23  ";"2001KW03";"429858";"1097";"1086";"11";"1017";"0";"430875"
"713";"PV23  ";"2001KW04";"430875";"2533";"2428";"105";"1950";"-388";"432437"
"714";"PV23  ";"2001JJ00";"428623";"5164";"5002";"162";"4202";"-388";"432437"
"715";"PV23  ";"2002KW01";"432437";"569";"561";"8";"460";"0";"432897"
"716";"PV23  ";"2002KW02";"432897";"619";"572";"47";"562";"0";"433459"
"717";"PV23  ";"2002KW03";"433459";"1009";"1000";"9";"871";"0";"434330"
"718";"PV23  ";"2002KW04";"434330";"1731";"1678";"53";"767";"440";"435537"
"719";"PV23  ";"2002JJ00";"432437";"3928";"3811";"117";"2660";"440";"435537"
"720";"PV23  ";"2003KW01";"435537";"400";"387";"13";"217";"0";"435754"
"721";"PV23  ";"2003KW02";"435754";"714";"694";"20";"541";"0";"436295"
"722";"PV23  ";"2003KW03";"436295";"1313";"1272";"41";"1003";"0";"437298"
"723";"PV23  ";"2003KW04";"437298";"2402";"2321";"81";"1967";"-694";"438571"
"724";"PV23  ";"2003JJ00";"435537";"4829";"4674";"155";"3728";"-694";"438571"
"725";"PV23  ";"2004KW01";"438571";"824";"792";"32";"750";"0";"439321"
"726";"PV23  ";"2004KW02";"439321";"912";"900";"12";"838";"0";"440159"
"727";"PV23  ";"2004KW03";"440159";"596";"568";"28";"485";"0";"440644"
"728";"PV23  ";"2004KW04";"440644";"2826";"2385";"441";"2001";"-326";"442319"
"729";"PV23  ";"2004JJ00";"438571";"5158";"4645";"513";"4074";"-326";"442319"
"730";"PV23  ";"2005KW01";"442319";"1344";"1318";"26";"1220";"0";"443539"
"731";"PV23  ";"2005KW02";"443539";"828";"779";"49";"653";"0";"444192"
"732";"PV23  ";"2005KW03";"444192";"604";"478";"126";"519";"0";"444711"
"733";"PV23  ";"2005KW04";"444711";"2484";"2393";"91";"2329";"-534";"446506"
"734";"PV23  ";"2005JJ00";"442319";"5260";"4968";"292";"4721";"-534";"446506"
"735";"PV23  ";"2006KW01";"446506";"1180";"1008";"172";"534";"0";"447040"
"736";"PV23  ";"2006KW02";"447040";"940";"623";"317";"618";"0";"447658"
"737";"PV23  ";"2006KW03";"447658";"1123";"1071";"52";"861";"0";"448519"
"738";"PV23  ";"2006KW04";"448519";"3084";"2784";"300";"2125";"-609";"450035"
"739";"PV23  ";"2006JJ00";"446506";"6327";"5486";"841";"4138";"-609";"450035"
"740";"PV23  ";"2007KW01";"450035";"847";"816";"31";"633";"0";"450668"
"741";"PV23  ";"2007KW02";"450668";"1494";"1400";"94";"1085";"0";"451753"
"742";"PV23  ";"2007KW03";"451753";"1733";"1396";"337";"1495";"0";"453248"
"743";"PV23  ";"2007KW04";"453248";"3347";"3255";"92";"2672";"-655";"455265"
"744";"PV23  ";"2007JJ00";"450035";"7421";"6867";"554";"5885";"-655";"455265"
"745";"PV23  ";"2008KW01";"456193";"947";"845";"102";"572";"0";"456765"
"746";"PV23  ";"2008KW02";"456765";"1471";"1414";"57";"935";"0";"457700"
"747";"PV23  ";"2008KW03";"457700";"777";"767";"10";"404";"0";"458104"
"748";"PV23  ";"2008KW04";"458104";"2957";"2907";"50";"2471";"-290";"460285"
"749";"PV23  ";"2008JJ00";"456193";"6152";"5933";"219";"4382";"-290";"460285"
"750";"PV23  ";"2009KW01";"460285";"695";"656";"39";"397";"0";"460682"
"751";"PV23  ";"2009KW02";"460682";"995";"986";"9";"645";"0";"461327"
"752";"PV23  ";"2009KW03";"461327";"1195";"1149";"46";"882";"0";"462209"
"753";"PV23  ";"2009KW04";"462209";"2056";"2028";"28";"1679";"-108";"463780"
"754";"PV23  ";"2009JJ00";"460285";"4941";"4819";"122";"3603";"-108";"463780"
"755";"PV23  ";"2010KW01";"463780";"730";"712";"18";"549";"0";"464329"
"756";"PV23  ";"2010KW02";"464329";"518";"473";"45";"-11";"0";"464318"
"757";"PV23  ";"2010KW03";"464318";"718";"697";"21";"584";"0";"464902"
"758";"PV23  ";"2010KW04";"464902";"1772";"1587";"185";"1265";"-231";"465936"
"759";"PV23  ";"2010JJ00";"463780";"3738";"3469";"269";"2387";"-231";"465936"
"760";"PV23  ";"2011KW01";"465936";"723";"647";"76";"633";"0";"466569"
"761";"PV23  ";"2011KW02";"466569";"1187";"1141";"46";"663";"0";"467232"
"762";"PV23  ";"2011KW03";"467232";"887";"865";"22";"718";"0";"467950"
"763";"PV23  ";"2011KW04";"467950";"1986";"1876";"110";"1477";"15";"469434"
"764";"PV23  ";"2011JJ00";"465936";"4783";"4529";"254";"3491";"15";"469442"
"765";"PV24  ";"1995KW01";"98671";"623";"618";"5";"621";"0";"99292"
"766";"PV24  ";"1995KW02";"99292";"1211";"1208";"3";"1210";"0";"100502"
"767";"PV24  ";"1995KW03";"100502";"1130";"1129";"1";"1123";"0";"101625"
"768";"PV24  ";"1995KW04";"101625";"2072";"2072";"0";"2046";"-208";"103463"
"769";"PV24  ";"1995JJ00";"98671";"5036";"5027";"9";"5000";"-208";"103463"
"770";"PV24  ";"1996KW01";"103463";"467";"467";"0";"456";"0";"103919"
"771";"PV24  ";"1996KW02";"103919";"579";"578";"1";"579";"0";"104498"
"772";"PV24  ";"1996KW03";"104498";"895";"886";"9";"895";"0";"105393"
"773";"PV24  ";"1996KW04";"105393";"2142";"2135";"7";"2136";"-110";"107419"
"774";"PV24  ";"1996JJ00";"103463";"4083";"4066";"17";"4066";"-110";"107419"
"775";"PV24  ";"1997KW01";"107419";"365";"365";"0";"361";"0";"107780"
"776";"PV24  ";"1997KW02";"107780";"839";"838";"1";"692";"0";"108472"
"777";"PV24  ";"1997KW03";"108472";"1575";"1557";"18";"1573";"0";"110045"
"778";"PV24  ";"1997KW04";"110045";"2862";"2859";"3";"2726";"132";"112903"
"779";"PV24  ";"1997JJ00";"107419";"5641";"5619";"22";"5352";"132";"112903"
"780";"PV24  ";"1998KW01";"112903";"1462";"1461";"1";"1460";"0";"114363"
"781";"PV24  ";"1998KW02";"114363";"399";"390";"9";"398";"0";"114761"
"782";"PV24  ";"1998KW03";"114761";"1022";"1019";"3";"1008";"0";"115769"
"783";"PV24  ";"1998KW04";"115769";"2504";"2499";"5";"2426";"-80";"118115"
"784";"PV24  ";"1998JJ00";"112903";"5387";"5369";"18";"5292";"-80";"118115"
"785";"PV24  ";"1999KW01";"118115";"463";"462";"1";"462";"0";"118577"
"786";"PV24  ";"1999KW02";"118577";"1045";"1041";"4";"1043";"0";"119620"
"787";"PV24  ";"1999KW03";"119620";"347";"347";"0";"342";"0";"119962"
"788";"PV24  ";"1999KW04";"119962";"2083";"2083";"0";"2081";"-10";"122033"
"789";"PV24  ";"1999JJ00";"118115";"3938";"3933";"5";"3928";"-10";"122033"
"790";"PV24  ";"2000KW01";"122033";"328";"328";"0";"318";"0";"122351"
"791";"PV24  ";"2000KW02";"122351";"601";"601";"0";"601";"0";"122952"
"792";"PV24  ";"2000KW03";"122952";"974";"973";"1";"969";"0";"123921"
"793";"PV24  ";"2000KW04";"123921";"2664";"2663";"1";"2643";"-22";"126542"
"794";"PV24  ";"2000JJ00";"122033";"4567";"4565";"2";"4531";"-22";"126542"
"795";"PV24  ";"2001KW01";"126542";"439";"397";"42";"436";"0";"126978"
"796";"PV24  ";"2001KW02";"126978";"595";"594";"1";"594";"0";"127572"
"797";"PV24  ";"2001KW03";"127572";"1263";"1263";"0";"1205";"0";"128777"
"798";"PV24  ";"2001KW04";"128777";"2400";"2397";"3";"2077";"-85";"130769"
"799";"PV24  ";"2001JJ00";"126542";"4697";"4651";"46";"4312";"-85";"130769"
"800";"PV24  ";"2002KW01";"130769";"576";"576";"0";"572";"0";"131341"
"801";"PV24  ";"2002KW02";"131341";"762";"761";"1";"756";"0";"132097"
"802";"PV24  ";"2002KW03";"132097";"619";"619";"0";"181";"0";"132278"
"803";"PV24  ";"2002KW04";"132278";"1644";"1636";"8";"1635";"14";"133927"
"804";"PV24  ";"2002JJ00";"130769";"3601";"3592";"9";"3144";"14";"133927"
"805";"PV24  ";"2003KW01";"133927";"307";"307";"0";"298";"0";"134225"
"806";"PV24  ";"2003KW02";"134225";"805";"805";"0";"774";"0";"134999"
"807";"PV24  ";"2003KW03";"134999";"880";"880";"0";"880";"0";"135879"
"808";"PV24  ";"2003KW04";"135879";"1831";"1830";"1";"1806";"-55";"137630"
"809";"PV24  ";"2003JJ00";"133927";"3823";"3822";"1";"3758";"-55";"137630"
"810";"PV24  ";"2004KW01";"137630";"275";"273";"2";"244";"0";"137874"
"811";"PV24  ";"2004KW02";"137874";"362";"359";"3";"358";"0";"138232"
"812";"PV24  ";"2004KW03";"138232";"100";"99";"1";"64";"0";"138296"
"813";"PV24  ";"2004KW04";"138296";"1634";"1620";"14";"1602";"-57";"139841"
"814";"PV24  ";"2004JJ00";"137630";"2371";"2351";"20";"2268";"-57";"139841"
"815";"PV24  ";"2005KW01";"139841";"73";"70";"3";"31";"0";"139872"
"816";"PV24  ";"2005KW02";"139872";"400";"398";"2";"393";"0";"140265"
"817";"PV24  ";"2005KW03";"140265";"448";"446";"2";"444";"0";"140709"
"818";"PV24  ";"2005KW04";"140709";"874";"872";"2";"849";"57";"141615"
"819";"PV24  ";"2005JJ00";"139841";"1795";"1786";"9";"1717";"57";"141615"
"820";"PV24  ";"2006KW01";"141615";"256";"253";"3";"229";"0";"141844"
"821";"PV24  ";"2006KW02";"141844";"294";"294";"0";"286";"0";"142130"
"822";"PV24  ";"2006KW03";"142130";"704";"704";"0";"701";"0";"142831"
"823";"PV24  ";"2006KW04";"142831";"851";"844";"7";"843";"-55";"143619"
"824";"PV24  ";"2006JJ00";"141615";"2105";"2095";"10";"2059";"-55";"143619"
"825";"PV24  ";"2007KW01";"143619";"229";"227";"2";"221";"0";"143840"
"826";"PV24  ";"2007KW02";"143840";"449";"447";"2";"449";"0";"144289"
"827";"PV24  ";"2007KW03";"144289";"628";"626";"2";"588";"0";"144877"
"828";"PV24  ";"2007KW04";"144877";"981";"960";"21";"951";"-45";"145783"
"829";"PV24  ";"2007JJ00";"143619";"2287";"2260";"27";"2209";"-45";"145783"
"830";"PV24  ";"2008KW01";"145871";"682";"681";"1";"679";"0";"146550"
"831";"PV24  ";"2008KW02";"146550";"380";"375";"5";"376";"0";"146926"
"832";"PV24  ";"2008KW03";"146926";"869";"869";"0";"846";"0";"147772"
"833";"PV24  ";"2008KW04";"147772";"871";"860";"11";"867";"24";"148663"
"834";"PV24  ";"2008JJ00";"145871";"2802";"2785";"17";"2768";"24";"148663"
"835";"PV24  ";"2009KW01";"148663";"559";"556";"3";"544";"0";"149207"
"836";"PV24  ";"2009KW02";"149207";"486";"486";"0";"485";"0";"149692"
"837";"PV24  ";"2009KW03";"149692";"538";"530";"8";"534";"0";"150226"
"838";"PV24  ";"2009KW04";"150226";"1109";"1105";"4";"1102";"-46";"151282"
"839";"PV24  ";"2009JJ00";"148663";"2692";"2677";"15";"2665";"-46";"151282"
"840";"PV24  ";"2010KW01";"151282";"465";"465";"0";"459";"0";"151741"
"841";"PV24  ";"2010KW02";"151741";"418";"414";"4";"411";"0";"152152"
"842";"PV24  ";"2010KW03";"152152";"537";"531";"6";"532";"0";"152684"
"843";"PV24  ";"2010KW04";"152684";"1223";"1223";"0";"1214";"-45";"153853"
"844";"PV24  ";"2010JJ00";"151282";"2643";"2633";"10";"2616";"-45";"153853"
"845";"PV24  ";"2011KW01";"153853";"408";"408";"0";"403";"0";"154256"
"846";"PV24  ";"2011KW02";"154256";"313";"304";"9";"309";"0";"154565"
"847";"PV24  ";"2011KW03";"154565";"362";"346";"16";"356";"0";"154921"
"848";"PV24  ";"2011KW04";"154921";"883";"841";"42";"855";"-57";"155719"
"849";"PV24  ";"2011JJ00";"153853";"1966";"1899";"67";"1923";"-57";"155719"
"850";"PV25  ";"1995KW01";"701609";"1806";"1750";"56";"1435";"0";"703044"
"851";"PV25  ";"1995KW02";"703044";"2283";"2235";"48";"1730";"0";"704774"
"852";"PV25  ";"1995KW03";"704774";"2410";"2308";"102";"2128";"0";"706902"
"853";"PV25  ";"1995KW04";"706902";"4882";"4666";"216";"4518";"-295";"711125"
"854";"PV25  ";"1995JJ00";"701609";"11381";"10959";"422";"9811";"-295";"711125"
"855";"PV25  ";"1996KW01";"711125";"938";"919";"19";"817";"0";"711942"
"856";"PV25  ";"1996KW02";"711942";"2397";"2338";"59";"2193";"0";"714135"
"857";"PV25  ";"1996KW03";"714135";"2799";"2685";"114";"2555";"0";"716690"
"858";"PV25  ";"1996KW04";"716690";"4826";"4404";"422";"4130";"-236";"720584"
"859";"PV25  ";"1996JJ00";"711125";"10960";"10346";"614";"9695";"-236";"720584"
"860";"PV25  ";"1997KW01";"720584";"1495";"1445";"50";"1249";"0";"721833"
"861";"PV25  ";"1997KW02";"721833";"2678";"2548";"130";"2471";"0";"724304"
"862";"PV25  ";"1997KW03";"724304";"2758";"2679";"79";"2514";"0";"726818"
"863";"PV25  ";"1997KW04";"726818";"4423";"4249";"174";"4118";"-318";"730618"
"864";"PV25  ";"1997JJ00";"720584";"11354";"10921";"433";"10352";"-318";"730618"
"865";"PV25  ";"1998KW01";"730467";"1635";"1591";"44";"1501";"0";"731968"
"866";"PV25  ";"1998KW02";"731968";"1444";"1379";"65";"1232";"0";"733200"
"867";"PV25  ";"1998KW03";"733200";"2254";"2189";"65";"2062";"0";"735262"
"868";"PV25  ";"1998KW04";"735262";"4250";"4037";"213";"3832";"-34";"739060"
"869";"PV25  ";"1998JJ00";"730467";"9583";"9196";"387";"8627";"-34";"739060"
"870";"PV25  ";"1999KW01";"739060";"1083";"1039";"44";"913";"0";"739973"
"871";"PV25  ";"1999KW02";"739973";"2171";"2118";"53";"1940";"0";"741913"
"872";"PV25  ";"1999KW03";"741913";"2285";"2242";"43";"2111";"0";"744024"
"873";"PV25  ";"1999KW04";"744024";"3439";"3294";"145";"2903";"-106";"746821"
"874";"PV25  ";"1999JJ00";"739060";"8978";"8693";"285";"7867";"-106";"746821"
"875";"PV25  ";"2000KW01";"746796";"1435";"1375";"60";"1255";"0";"748051"
"876";"PV25  ";"2000KW02";"748051";"1285";"1221";"64";"1079";"0";"749130"
"877";"PV25  ";"2000KW03";"749130";"1290";"1230";"60";"964";"0";"750094"
"878";"PV25  ";"2000KW04";"750094";"3714";"3534";"180";"3421";"-162";"753353"
"879";"PV25  ";"2000JJ00";"746796";"7724";"7360";"364";"6719";"-162";"753353"
"880";"PV25  ";"2001KW01";"753353";"847";"767";"80";"647";"0";"754000"
"881";"PV25  ";"2001KW02";"754000";"1290";"1192";"98";"1142";"0";"755142"
"882";"PV25  ";"2001KW03";"755142";"1441";"1274";"167";"1295";"0";"756437"
"883";"PV25  ";"2001KW04";"756437";"3473";"3235";"238";"2905";"16";"759358"
"884";"PV25  ";"2001JJ00";"753353";"7051";"6468";"583";"5989";"16";"759358"
"885";"PV25  ";"2002KW01";"759358";"1217";"1124";"93";"990";"0";"760348"
"886";"PV25  ";"2002KW02";"760348";"1929";"1852";"77";"1663";"0";"762011"
"887";"PV25  ";"2002KW03";"762011";"1061";"995";"66";"747";"0";"762758"
"888";"PV25  ";"2002KW04";"762758";"2660";"2568";"92";"2376";"-138";"764996"
"889";"PV25  ";"2002JJ00";"759358";"6867";"6539";"328";"5776";"-138";"764996"
"890";"PV25  ";"2003KW01";"764996";"685";"647";"38";"438";"0";"765434"
"891";"PV25  ";"2003KW02";"765434";"1057";"977";"80";"861";"0";"766295"
"892";"PV25  ";"2003KW03";"766295";"882";"819";"63";"262";"0";"766557"
"893";"PV25  ";"2003KW04";"766557";"3461";"3112";"349";"3039";"6";"769602"
"894";"PV25  ";"2003JJ00";"764996";"6085";"5555";"530";"4600";"6";"769602"
"895";"PV25  ";"2004KW01";"769602";"819";"796";"23";"613";"0";"770215"
"896";"PV25  ";"2004KW02";"770215";"1395";"1350";"45";"1159";"0";"771374"
"897";"PV25  ";"2004KW03";"771374";"1280";"1229";"51";"938";"0";"772312"
"898";"PV25  ";"2004KW04";"772312";"4957";"4546";"411";"4241";"-598";"775955"
"899";"PV25  ";"2004JJ00";"769602";"8451";"7921";"530";"6951";"-598";"775955"
"900";"PV25  ";"2005KW01";"775955";"1090";"1037";"53";"928";"0";"776883"
"901";"PV25  ";"2005KW02";"776883";"1612";"1540";"72";"1426";"0";"778309"
"902";"PV25  ";"2005KW03";"778309";"1967";"1877";"90";"1717";"0";"780026"
"903";"PV25  ";"2005KW04";"780026";"3158";"2959";"199";"2704";"-104";"782626"
"904";"PV25  ";"2005JJ00";"775955";"7827";"7413";"414";"6775";"-104";"782626"
"905";"PV25  ";"2006KW01";"782626";"1385";"1323";"62";"1002";"0";"783628"
"906";"PV25  ";"2006KW02";"783628";"1790";"1704";"86";"1379";"0";"785007"
"907";"PV25  ";"2006KW03";"785007";"2290";"2118";"172";"1945";"0";"786952"
"908";"PV25  ";"2006KW04";"786952";"3414";"3178";"236";"2830";"-400";"789382"
"909";"PV25  ";"2006JJ00";"782626";"8879";"8323";"556";"7156";"-400";"789382"
"910";"PV25  ";"2007KW01";"789382";"1374";"1200";"174";"1116";"0";"790498"
"911";"PV25  ";"2007KW02";"790498";"1613";"1524";"89";"1315";"0";"791813"
"912";"PV25  ";"2007KW03";"791813";"1892";"1766";"126";"1531";"0";"793344"
"913";"PV25  ";"2007KW04";"793344";"4343";"4160";"183";"3625";"21";"796990"
"914";"PV25  ";"2007JJ00";"789382";"9222";"8650";"572";"7587";"21";"796990"
"915";"PV25  ";"2008KW01";"799507";"1828";"1675";"153";"1503";"0";"801010"
"916";"PV25  ";"2008KW02";"801010";"2587";"2405";"182";"1989";"0";"802999"
"917";"PV25  ";"2008KW03";"802999";"1842";"1663";"179";"1446";"0";"804445"
"918";"PV25  ";"2008KW04";"804445";"4660";"4335";"325";"3870";"-775";"807540"
"919";"PV25  ";"2008JJ00";"799507";"10917";"10078";"839";"8808";"-775";"807540"
"920";"PV25  ";"2009KW01";"807540";"2123";"1960";"163";"1297";"0";"808837"
"921";"PV25  ";"2009KW02";"808837";"2382";"2265";"117";"1723";"0";"810560"
"922";"PV25  ";"2009KW03";"810560";"1969";"1834";"135";"1560";"0";"812120"
"923";"PV25  ";"2009KW04";"812120";"5593";"5269";"324";"5184";"-410";"816894"
"924";"PV25  ";"2009JJ00";"807540";"12067";"11328";"739";"9764";"-410";"816894"
"925";"PV25  ";"2010KW01";"816894";"896";"641";"255";"578";"0";"817472"
"926";"PV25  ";"2010KW02";"817472";"1082";"986";"96";"718";"0";"818190"
"927";"PV25  ";"2010KW03";"818190";"1272";"1186";"86";"778";"0";"818968"
"928";"PV25  ";"2010KW04";"818968";"3896";"3685";"211";"3476";"-258";"822186"
"929";"PV25  ";"2010JJ00";"816894";"7146";"6498";"648";"5550";"-258";"822186"
"930";"PV25  ";"2011KW01";"822186";"1342";"1189";"153";"1133";"0";"823319"
"931";"PV25  ";"2011KW02";"823319";"1854";"1603";"251";"1649";"0";"824968"
"932";"PV25  ";"2011KW03";"824968";"2201";"1862";"339";"2040";"0";"827008"
"933";"PV25  ";"2011KW04";"827008";"3214";"2509";"705";"2922";"-484";"829423"
"934";"PV25  ";"2011JJ00";"822186";"8611";"7163";"1448";"7744";"-484";"829446"
"935";"PV26  ";"1995KW01";"415898";"1162";"1097";"65";"955";"0";"416853"
"936";"PV26  ";"1995KW02";"416853";"1205";"1102";"103";"1112";"0";"417965"
"937";"PV26  ";"1995KW03";"417965";"1079";"1043";"36";"1026";"0";"418991"
"938";"PV26  ";"1995KW04";"418991";"2352";"2291";"61";"2195";"222";"421408"
"939";"PV26  ";"1995JJ00";"415898";"5798";"5533";"265";"5288";"222";"421408"
"940";"PV26  ";"1996KW01";"421408";"1138";"1094";"44";"1089";"0";"422497"
"941";"PV26  ";"1996KW02";"422497";"1316";"1269";"47";"1259";"0";"423756"
"942";"PV26  ";"1996KW03";"423756";"2109";"1959";"150";"2029";"0";"425785"
"943";"PV26  ";"1996KW04";"425785";"3467";"3367";"100";"3209";"-497";"428497"
"944";"PV26  ";"1996JJ00";"421408";"8030";"7689";"341";"7586";"-497";"428497"
"945";"PV26  ";"1997KW01";"428497";"1070";"1026";"44";"906";"0";"429403"
"946";"PV26  ";"1997KW02";"429403";"1654";"1650";"4";"1635";"0";"431038"
"947";"PV26  ";"1997KW03";"431038";"1267";"1148";"119";"873";"0";"431911"
"948";"PV26  ";"1997KW04";"431911";"3214";"3075";"139";"2794";"-146";"434559"
"949";"PV26  ";"1997JJ00";"428497";"7205";"6899";"306";"6208";"-146";"434559"
"950";"PV26  ";"1998KW01";"434710";"1039";"1014";"25";"1011";"0";"435721"
"951";"PV26  ";"1998KW02";"435721";"1375";"1322";"53";"1302";"0";"437023"
"952";"PV26  ";"1998KW03";"437023";"846";"755";"91";"670";"0";"437693"
"953";"PV26  ";"1998KW04";"437693";"2751";"2677";"74";"2613";"103";"440409"
"954";"PV26  ";"1998JJ00";"434710";"6011";"5768";"243";"5596";"103";"440409"
"955";"PV26  ";"1999KW01";"440409";"967";"958";"9";"955";"0";"441364"
"956";"PV26  ";"1999KW02";"441364";"1697";"1610";"87";"1587";"0";"442951"
"957";"PV26  ";"1999KW03";"442951";"1463";"1424";"39";"1416";"0";"444367"
"958";"PV26  ";"1999KW04";"444367";"2673";"2532";"141";"2369";"-223";"446513"
"959";"PV26  ";"1999JJ00";"440409";"6800";"6524";"276";"6327";"-223";"446513"
"960";"PV26  ";"2000KW01";"446513";"737";"697";"40";"684";"0";"447197"
"961";"PV26  ";"2000KW02";"447197";"1716";"1700";"16";"1653";"0";"448850"
"962";"PV26  ";"2000KW03";"448850";"1301";"1271";"30";"1185";"0";"450035"
"963";"PV26  ";"2000KW04";"450035";"2985";"2817";"168";"2868";"333";"453236"
"964";"PV26  ";"2000JJ00";"446513";"6739";"6485";"254";"6390";"333";"453236"
"965";"PV26  ";"2001KW01";"453236";"1380";"1329";"51";"1029";"0";"454265"
"966";"PV26  ";"2001KW02";"454265";"1630";"1490";"140";"1559";"0";"455824"
"967";"PV26  ";"2001KW03";"455824";"1443";"1412";"31";"1266";"0";"457090"
"968";"PV26  ";"2001KW04";"457090";"2862";"2795";"67";"2642";"-766";"458966"
"969";"PV26  ";"2001JJ00";"453236";"7315";"7026";"289";"6496";"-766";"458966"
"970";"PV26  ";"2002KW01";"462807";"1088";"1061";"27";"902";"0";"463709"
"971";"PV26  ";"2002KW02";"463709";"1400";"1366";"34";"1298";"0";"465007"
"972";"PV26  ";"2002KW03";"465007";"1551";"1492";"59";"1372";"0";"466379"
"973";"PV26  ";"2002KW04";"466379";"1580";"1525";"55";"1448";"-75";"467752"
"974";"PV26  ";"2002JJ00";"462807";"5619";"5444";"175";"5020";"-75";"467752"
"975";"PV26  ";"2003KW01";"467752";"789";"772";"17";"746";"0";"468498"
"976";"PV26  ";"2003KW02";"468498";"831";"809";"22";"737";"0";"469235"
"977";"PV26  ";"2003KW03";"469235";"1152";"1089";"63";"1091";"0";"470326"
"978";"PV26  ";"2003KW04";"470326";"1900";"1824";"76";"1756";"-69";"472013"
"979";"PV26  ";"2003JJ00";"467752";"4672";"4494";"178";"4330";"-69";"472013"
"980";"PV26  ";"2004KW01";"472013";"784";"708";"76";"207";"0";"472220"
"981";"PV26  ";"2004KW02";"472220";"1381";"1151";"230";"1288";"0";"473508"
"982";"PV26  ";"2004KW03";"473508";"593";"477";"116";"564";"0";"474072"
"983";"PV26  ";"2004KW04";"474072";"3320";"2561";"759";"2381";"-427";"476026"
"984";"PV26  ";"2004JJ00";"472013";"6078";"4897";"1181";"4440";"-427";"476026"
"985";"PV26  ";"2005KW01";"476026";"633";"589";"44";"571";"0";"476597"
"986";"PV26  ";"2005KW02";"476597";"1312";"1294";"18";"1260";"0";"477857"
"987";"PV26  ";"2005KW03";"477857";"1260";"1186";"74";"1233";"0";"479090"
"988";"PV26  ";"2005KW04";"479090";"3662";"3518";"144";"3438";"-104";"482424"
"989";"PV26  ";"2005JJ00";"476026";"6867";"6587";"280";"6502";"-104";"482424"
"990";"PV26  ";"2006KW01";"482424";"1182";"1158";"24";"945";"0";"483369"
"991";"PV26  ";"2006KW02";"483369";"1072";"1049";"23";"983";"0";"484352"
"992";"PV26  ";"2006KW03";"484352";"1108";"1094";"14";"1064";"0";"485416"
"993";"PV26  ";"2006KW04";"485416";"2448";"2351";"97";"2096";"-175";"487337"
"994";"PV26  ";"2006JJ00";"482424";"5810";"5652";"158";"5088";"-175";"487337"
"995";"PV26  ";"2007KW01";"487337";"627";"610";"17";"594";"0";"487931"
"996";"PV26  ";"2007KW02";"487931";"1284";"1263";"21";"1177";"0";"489108"
"997";"PV26  ";"2007KW03";"489108";"997";"979";"18";"861";"0";"489969"
"998";"PV26  ";"2007KW04";"489969";"3733";"3412";"321";"3508";"-144";"493333"
"999";"PV26  ";"2007JJ00";"487337";"6641";"6264";"377";"6140";"-144";"493333"
"1000";"PV26  ";"2008KW01";"494230";"622";"613";"9";"604";"0";"494834"
"1001";"PV26  ";"2008KW02";"494834";"1039";"1023";"16";"1006";"0";"495840"
"1002";"PV26  ";"2008KW03";"495840";"1471";"1459";"12";"1386";"0";"497226"
"1003";"PV26  ";"2008KW04";"497226";"3866";"3387";"479";"3170";"-314";"500082"
"1004";"PV26  ";"2008JJ00";"494230";"6998";"6482";"516";"6166";"-314";"500082"
"1005";"PV26  ";"2009KW01";"500082";"817";"813";"4";"774";"0";"500856"
"1006";"PV26  ";"2009KW02";"500856";"800";"744";"56";"606";"0";"501462"
"1007";"PV26  ";"2009KW03";"501462";"868";"839";"29";"822";"0";"502284"
"1008";"PV26  ";"2009KW04";"502284";"4337";"4042";"295";"4068";"-163";"506189"
"1009";"PV26  ";"2009JJ00";"500082";"6822";"6438";"384";"6270";"-163";"506189"
"1010";"PV26  ";"2010KW01";"506189";"606";"601";"5";"599";"0";"506788"
"1011";"PV26  ";"2010KW02";"506788";"441";"382";"59";"367";"0";"507155"
"1012";"PV26  ";"2010KW03";"507155";"1322";"1228";"94";"1174";"0";"508329"
"1013";"PV26  ";"2010KW04";"508329";"1332";"1254";"78";"1290";"232";"509851"
"1014";"PV26  ";"2010JJ00";"506189";"3701";"3465";"236";"3430";"232";"509851"
"1015";"PV26  ";"2011KW01";"509851";"1235";"1166";"69";"1059";"0";"510910"
"1016";"PV26  ";"2011KW02";"510910";"433";"420";"13";"396";"0";"511306"
"1017";"PV26  ";"2011KW03";"511306";"651";"628";"23";"575";"0";"511881"
"1018";"PV26  ";"2011KW04";"511881";"3172";"2416";"756";"2675";"-720";"513364"
"1019";"PV26  ";"2011JJ00";"509851";"5491";"4630";"861";"4705";"-720";"513836"
"1020";"PV27  ";"1995KW01";"1057536";"2463";"2365";"98";"2334";"0";"1059870"
"1021";"PV27  ";"1995KW02";"1059870";"3129";"2816";"313";"2665";"0";"1062535"
"1022";"PV27  ";"1995KW03";"1062535";"3565";"3138";"427";"2786";"0";"1065321"
"1023";"PV27  ";"1995KW04";"1065321";"5976";"5664";"312";"5512";"-57";"1070776"
"1024";"PV27  ";"1995JJ00";"1057536";"15133";"13983";"1150";"13297";"-57";"1070776"
"1025";"PV27  ";"1996KW01";"1070776";"1360";"1231";"129";"1231";"0";"1072007"
"1026";"PV27  ";"1996KW02";"1072007";"3212";"2966";"246";"2857";"0";"1074864"
"1027";"PV27  ";"1996KW03";"1074864";"3001";"2486";"515";"2372";"0";"1077236"
"1028";"PV27  ";"1996KW04";"1077236";"4685";"4265";"420";"4205";"-459";"1080982"
"1029";"PV27  ";"1996JJ00";"1070776";"12258";"10948";"1310";"10665";"-459";"1080982"
"1030";"PV27  ";"1997KW01";"1080982";"1590";"1544";"46";"1416";"0";"1082398"
"1031";"PV27  ";"1997KW02";"1082398";"2346";"2100";"246";"2003";"0";"1084401"
"1032";"PV27  ";"1997KW03";"1084401";"2243";"2167";"76";"2092";"0";"1086493"
"1033";"PV27  ";"1997KW04";"1086493";"7350";"6613";"737";"6785";"226";"1093504"
"1034";"PV27  ";"1997JJ00";"1080982";"13529";"12424";"1105";"12296";"226";"1093504"
"1035";"PV27  ";"1998KW01";"1093504";"3482";"3183";"299";"3211";"0";"1096715"
"1036";"PV27  ";"1998KW02";"1096715";"4074";"4042";"32";"3956";"0";"1100671"
"1037";"PV27  ";"1998KW03";"1100671";"3626";"2913";"713";"2445";"0";"1103116"
"1038";"PV27  ";"1998KW04";"1103116";"5509";"4857";"652";"4506";"-891";"1106731"
"1039";"PV27  ";"1998JJ00";"1093504";"16691";"14995";"1696";"14118";"-891";"1106731"
"1040";"PV27  ";"1999KW01";"1106731";"2496";"2379";"117";"2340";"0";"1109071"
"1041";"PV27  ";"1999KW02";"1109071";"3310";"2638";"672";"1828";"0";"1110899"
"1042";"PV27  ";"1999KW03";"1110899";"2881";"2618";"263";"2633";"0";"1113532"
"1043";"PV27  ";"1999KW04";"1113532";"4469";"4041";"428";"3344";"-341";"1116535"
"1044";"PV27  ";"1999JJ00";"1106731";"13156";"11676";"1480";"10145";"-341";"1116535"
"1045";"PV27  ";"2000KW01";"1116535";"1846";"1561";"285";"1131";"0";"1117666"
"1046";"PV27  ";"2000KW02";"1117666";"1876";"1622";"254";"1464";"0";"1119130"
"1047";"PV27  ";"2000KW03";"1119130";"2596";"2299";"297";"2020";"0";"1121150"
"1048";"PV27  ";"2000KW04";"1121150";"5600";"4614";"986";"4137";"454";"1125741"
"1049";"PV27  ";"2000JJ00";"1116535";"11918";"10096";"1822";"8752";"454";"1125741"
"1050";"PV27  ";"2001KW01";"1125741";"2306";"2022";"284";"1472";"0";"1127213"
"1051";"PV27  ";"2001KW02";"1127213";"2047";"1637";"410";"1345";"0";"1128558"
"1052";"PV27  ";"2001KW03";"1128558";"2660";"2429";"231";"2239";"0";"1130797"
"1053";"PV27  ";"2001KW04";"1130797";"5654";"5065";"589";"4972";"-699";"1135070"
"1054";"PV27  ";"2001JJ00";"1125741";"12667";"11153";"1514";"10028";"-699";"1135070"
"1055";"PV27  ";"2002KW01";"1138747";"1619";"1134";"485";"779";"0";"1139526"
"1056";"PV27  ";"2002KW02";"1139526";"2887";"2531";"356";"2300";"0";"1141826"
"1057";"PV27  ";"2002KW03";"1141826";"2296";"1865";"431";"1748";"0";"1143574"
"1058";"PV27  ";"2002KW04";"1143574";"5392";"4982";"410";"4722";"-56";"1148240"
"1059";"PV27  ";"2002JJ00";"1138747";"12194";"10512";"1682";"9549";"-56";"1148240"
"1060";"PV27  ";"2003KW01";"1148240";"1698";"1586";"112";"1606";"0";"1149846"
"1061";"PV27  ";"2003KW02";"1149846";"2496";"1787";"709";"1343";"0";"1151189"
"1062";"PV27  ";"2003KW03";"1151189";"2222";"1709";"513";"1406";"0";"1152595"
"1063";"PV27  ";"2003KW04";"1152595";"6718";"5611";"1107";"5206";"-28";"1157773"
"1064";"PV27  ";"2003JJ00";"1148240";"13134";"10693";"2441";"9561";"-28";"1157773"
"1065";"PV27  ";"2004KW01";"1157773";"1227";"1126";"101";"992";"0";"1158765"
"1066";"PV27  ";"2004KW02";"1158765";"2547";"2104";"443";"1828";"0";"1160593"
"1067";"PV27  ";"2004KW03";"1160593";"1595";"1435";"160";"1313";"0";"1161906"
"1068";"PV27  ";"2004KW04";"1161906";"4491";"4231";"260";"4172";"-65";"1166013"
"1069";"PV27  ";"2004JJ00";"1157773";"9860";"8896";"964";"8305";"-65";"1166013"
"1070";"PV27  ";"2005KW01";"1166013";"2159";"1183";"976";"736";"0";"1166749"
"1071";"PV27  ";"2005KW02";"1166749";"2658";"1969";"689";"941";"0";"1167690"
"1072";"PV27  ";"2005KW03";"1167690";"3092";"2471";"621";"1599";"0";"1169289"
"1073";"PV27  ";"2005KW04";"1169289";"6546";"5126";"1420";"4779";"-242";"1173826"
"1074";"PV27  ";"2005JJ00";"1166013";"14455";"10749";"3706";"8055";"-242";"1173826"
"1075";"PV27  ";"2006KW01";"1173826";"2556";"2062";"494";"1554";"0";"1175380"
"1076";"PV27  ";"2006KW02";"1175380";"2425";"2029";"396";"1962";"0";"1177342"
"1077";"PV27  ";"2006KW03";"1177342";"2724";"2228";"496";"892";"0";"1178234"
"1078";"PV27  ";"2006KW04";"1178234";"6370";"5397";"973";"4779";"-512";"1182501"
"1079";"PV27  ";"2006JJ00";"1173826";"14075";"11716";"2359";"9187";"-512";"1182501"
"1080";"PV27  ";"2007KW01";"1182501";"1905";"1591";"314";"254";"0";"1182755"
"1081";"PV27  ";"2007KW02";"1182755";"1704";"1513";"191";"1322";"0";"1184077"
"1082";"PV27  ";"2007KW03";"1184077";"3662";"2993";"669";"1021";"0";"1185098"
"1083";"PV27  ";"2007KW04";"1185098";"9831";"8850";"981";"8228";"678";"1194004"
"1084";"PV27  ";"2007JJ00";"1182501";"17102";"14947";"2155";"10825";"678";"1194004"
"1085";"PV27  ";"2008KW01";"1196684";"3493";"2628";"865";"2762";"0";"1199446"
"1086";"PV27  ";"2008KW02";"1199446";"2627";"1978";"649";"2074";"0";"1201520"
"1087";"PV27  ";"2008KW03";"1201520";"2167";"2096";"71";"1828";"0";"1203348"
"1088";"PV27  ";"2008KW04";"1203348";"6620";"5856";"764";"4329";"66";"1207743"
"1089";"PV27  ";"2008JJ00";"1196684";"14907";"12558";"2349";"10993";"66";"1207743"
"1090";"PV27  ";"2009KW01";"1207743";"3088";"2574";"514";"2091";"0";"1209834"
"1091";"PV27  ";"2009KW02";"1209834";"2806";"2409";"397";"2024";"0";"1211858"
"1092";"PV27  ";"2009KW03";"1211858";"3163";"2667";"496";"2654";"0";"1214512"
"1093";"PV27  ";"2009KW04";"1214512";"6462";"5792";"670";"4724";"-783";"1218453"
"1094";"PV27  ";"2009JJ00";"1207743";"15519";"13442";"2077";"11493";"-783";"1218453"
"1095";"PV27  ";"2010KW01";"1218453";"1227";"1157";"70";"973";"0";"1219426"
"1096";"PV27  ";"2010KW02";"1219426";"3794";"2801";"993";"1755";"0";"1221181"
"1097";"PV27  ";"2010KW03";"1221181";"3317";"2906";"411";"2463";"0";"1223644"
"1098";"PV27  ";"2010KW04";"1223644";"3312";"3031";"281";"2845";"-611";"1225878"
"1099";"PV27  ";"2010JJ00";"1218453";"11650";"9895";"1755";"8036";"-611";"1225878"
"1100";"PV27  ";"2011KW01";"1225878";"1537";"1140";"397";"698";"0";"1226576"
"1101";"PV27  ";"2011KW02";"1226576";"2215";"1791";"424";"1859";"0";"1228435"
"1102";"PV27  ";"2011KW03";"1228435";"2267";"1773";"494";"1682";"0";"1230117"
"1103";"PV27  ";"2011KW04";"1230117";"5438";"4758";"680";"4450";"-50";"1234455"
"1104";"PV27  ";"2011JJ00";"1225878";"11457";"9462";"1995";"8689";"-50";"1234517"
"1105";"PV28  ";"1995KW01";"1387250";"3303";"3010";"293";"2314";"0";"1389564"
"1106";"PV28  ";"1995KW02";"1389564";"4248";"4078";"170";"3491";"0";"1393055"
"1107";"PV28  ";"1995KW03";"1393055";"4122";"3999";"123";"3124";"0";"1396179"
"1108";"PV28  ";"1995KW04";"1396179";"7383";"6990";"393";"5497";"-7";"1401669"
"1109";"PV28  ";"1995JJ00";"1387250";"19056";"18077";"979";"14426";"-7";"1401669"
"1110";"PV28  ";"1996KW01";"1401669";"2930";"2778";"152";"2190";"0";"1403859"
"1111";"PV28  ";"1996KW02";"1403859";"5094";"4977";"117";"4604";"0";"1408463"
"1112";"PV28  ";"1996KW03";"1408463";"5387";"4864";"523";"4627";"0";"1413090"
"1113";"PV28  ";"1996KW04";"1413090";"6890";"6453";"437";"5819";"-29";"1418880"
"1114";"PV28  ";"1996JJ00";"1401669";"20301";"19072";"1229";"17240";"-29";"1418880"
"1115";"PV28  ";"1997KW01";"1418880";"2549";"2450";"99";"1828";"0";"1420708"
"1116";"PV28  ";"1997KW02";"1420708";"5240";"5075";"165";"4077";"0";"1424785"
"1117";"PV28  ";"1997KW03";"1424785";"4182";"4014";"168";"3203";"0";"1427988"
"1118";"PV28  ";"1997KW04";"1427988";"6073";"5582";"491";"4331";"-576";"1431743"
"1119";"PV28  ";"1997JJ00";"1418880";"18044";"17121";"923";"13439";"-576";"1431743"
"1120";"PV28  ";"1998KW01";"1431743";"3892";"3788";"104";"3501";"0";"1435244"
"1121";"PV28  ";"1998KW02";"1435244";"5239";"5007";"232";"3964";"0";"1439208"
"1122";"PV28  ";"1998KW03";"1439208";"4499";"4204";"295";"3403";"0";"1442611"
"1123";"PV28  ";"1998KW04";"1442611";"6712";"6425";"287";"5020";"-222";"1447409"
"1124";"PV28  ";"1998JJ00";"1431743";"20342";"19424";"918";"15888";"-222";"1447409"
"1125";"PV28  ";"1999KW01";"1447409";"3134";"3025";"109";"2131";"0";"1449540"
"1126";"PV28  ";"1999KW02";"1449540";"4542";"4300";"242";"3728";"0";"1453268"
"1127";"PV28  ";"1999KW03";"1453268";"2993";"2891";"102";"2407";"0";"1455675"
"1128";"PV28  ";"1999KW04";"1455675";"6207";"6052";"155";"5198";"147";"1461020"
"1129";"PV28  ";"1999JJ00";"1447409";"16876";"16268";"608";"13464";"147";"1461020"
"1130";"PV28  ";"2000KW01";"1461020";"2830";"2752";"78";"2207";"0";"1463227"
"1131";"PV28  ";"2000KW02";"1463227";"4142";"4029";"113";"3497";"0";"1466724"
"1132";"PV28  ";"2000KW03";"1466724";"3229";"3105";"124";"2378";"0";"1469102"
"1133";"PV28  ";"2000KW04";"1469102";"5077";"4698";"379";"2855";"522";"1472479"
"1134";"PV28  ";"2000JJ00";"1461020";"15278";"14584";"694";"10937";"522";"1472479"
"1135";"PV28  ";"2001KW01";"1472479";"2684";"2448";"236";"1448";"0";"1473927"
"1136";"PV28  ";"2001KW02";"1473927";"4986";"4784";"202";"4281";"0";"1478208"
"1137";"PV28  ";"2001KW03";"1478208";"4088";"3781";"307";"3119";"0";"1481327"
"1138";"PV28  ";"2001KW04";"1481327";"6252";"5952";"300";"5274";"-1034";"1485567"
"1139";"PV28  ";"2001JJ00";"1472479";"18010";"16965";"1045";"14122";"-1034";"1485567"
"1140";"PV28  ";"2002KW01";"1478049";"2129";"2072";"57";"1133";"0";"1479182"
"1141";"PV28  ";"2002KW02";"1479182";"4444";"4348";"96";"3208";"0";"1482390"
"1142";"PV28  ";"2002KW03";"1482390";"3826";"3682";"144";"3002";"0";"1485392"
"1143";"PV28  ";"2002KW04";"1485392";"7699";"6902";"797";"5744";"-203";"1490933"
"1144";"PV28  ";"2002JJ00";"1478049";"18098";"17004";"1094";"13087";"-203";"1490933"
"1145";"PV28  ";"2003KW01";"1490933";"1629";"1538";"91";"634";"0";"1491567"
"1146";"PV28  ";"2003KW02";"1491567";"3620";"3499";"121";"2562";"0";"1494129"
"1147";"PV28  ";"2003KW03";"1494129";"2358";"2202";"156";"1679";"0";"1495808"
"1148";"PV28  ";"2003KW04";"1495808";"7241";"6719";"522";"4221";"-331";"1499698"
"1149";"PV28  ";"2003JJ00";"1490933";"14848";"13958";"890";"9096";"-331";"1499698"
"1150";"PV28  ";"2004KW01";"1499698";"2988";"2747";"241";"1770";"0";"1501468"
"1151";"PV28  ";"2004KW02";"1501468";"3209";"3099";"110";"2169";"0";"1503637"
"1152";"PV28  ";"2004KW03";"1503637";"2622";"2363";"259";"1265";"0";"1504902"
"1153";"PV28  ";"2004KW04";"1504902";"7377";"6624";"753";"3750";"-249";"1508403"
"1154";"PV28  ";"2004JJ00";"1499698";"16196";"14833";"1363";"8954";"-249";"1508403"
"1155";"PV28  ";"2005KW01";"1508403";"2714";"2560";"154";"1155";"0";"1509558"
"1156";"PV28  ";"2005KW02";"1509558";"4357";"4215";"142";"3450";"0";"1513008"
"1157";"PV28  ";"2005KW03";"1513008";"3517";"3265";"252";"2510";"0";"1515518"
"1158";"PV28  ";"2005KW04";"1515518";"6006";"5709";"297";"4558";"-145";"1519931"
"1159";"PV28  ";"2005JJ00";"1508403";"16594";"15749";"845";"11673";"-145";"1519931"
"1160";"PV28  ";"2006KW01";"1519931";"3392";"3165";"227";"1430";"0";"1521361"
"1161";"PV28  ";"2006KW02";"1521361";"3873";"3594";"279";"2415";"0";"1523776"
"1162";"PV28  ";"2006KW03";"1523776";"3211";"2921";"290";"2403";"0";"1526179"
"1163";"PV28  ";"2006KW04";"1526179";"6261";"5990";"271";"4645";"-570";"1530254"
"1164";"PV28  ";"2006JJ00";"1519931";"16737";"15670";"1067";"10893";"-570";"1530254"
"1165";"PV28  ";"2007KW01";"1530254";"3123";"2935";"188";"1064";"0";"1531318"
"1166";"PV28  ";"2007KW02";"1531318";"3569";"3165";"404";"1799";"0";"1533117"
"1167";"PV28  ";"2007KW03";"1533117";"3642";"3333";"309";"2146";"0";"1535263"
"1168";"PV28  ";"2007KW04";"1535263";"7013";"6657";"356";"4602";"-422";"1539443"
"1169";"PV28  ";"2007JJ00";"1530254";"17347";"16090";"1257";"9611";"-422";"1539443"
"1170";"PV28  ";"2008KW01";"1540715";"3430";"3124";"306";"1563";"0";"1542278"
"1171";"PV28  ";"2008KW02";"1542278";"3996";"3701";"295";"2901";"0";"1545179"
"1172";"PV28  ";"2008KW03";"1545179";"3751";"3464";"287";"2438";"0";"1547617"
"1173";"PV28  ";"2008KW04";"1547617";"7476";"6749";"727";"5275";"-226";"1552666"
"1174";"PV28  ";"2008JJ00";"1540715";"18653";"17038";"1615";"12177";"-226";"1552666"
"1175";"PV28  ";"2009KW01";"1552666";"2965";"2777";"188";"1544";"0";"1554210"
"1176";"PV28  ";"2009KW02";"1554210";"3674";"3422";"252";"2776";"0";"1556986"
"1177";"PV28  ";"2009KW03";"1556986";"4584";"4462";"122";"4011";"0";"1560997"
"1178";"PV28  ";"2009KW04";"1560997";"10297";"8921";"1376";"7162";"-623";"1567536"
"1179";"PV28  ";"2009JJ00";"1552666";"21520";"19582";"1938";"15493";"-623";"1567536"
"1180";"PV28  ";"2010KW01";"1567536";"2223";"1894";"329";"1775";"0";"1569311"
"1181";"PV28  ";"2010KW02";"1569311";"3014";"2529";"485";"2260";"0";"1571571"
"1182";"PV28  ";"2010KW03";"1571571";"3456";"2978";"478";"2795";"0";"1574366"
"1183";"PV28  ";"2010KW04";"1574366";"6376";"5760";"616";"4705";"-190";"1578881"
"1184";"PV28  ";"2010JJ00";"1567536";"15069";"13161";"1908";"11535";"-190";"1578881"
"1185";"PV28  ";"2011KW01";"1578881";"1626";"1457";"169";"843";"0";"1579724"
"1186";"PV28  ";"2011KW02";"1579724";"2532";"2325";"207";"1689";"0";"1581413"
"1187";"PV28  ";"2011KW03";"1581413";"3098";"2849";"249";"1746";"0";"1583159"
"1188";"PV28  ";"2011KW04";"1583159";"6011";"5436";"575";"4437";"-195";"1587384"
"1189";"PV28  ";"2011JJ00";"1578881";"13267";"12067";"1200";"8715";"-195";"1587401"
"1190";"PV29  ";"1995KW01";"155307";"489";"465";"24";"432";"0";"155739"
"1191";"PV29  ";"1995KW02";"155739";"554";"519";"35";"389";"0";"156128"
"1192";"PV29  ";"1995KW03";"156128";"518";"467";"51";"415";"0";"156543"
"1193";"PV29  ";"1995KW04";"156543";"849";"802";"47";"649";"-39";"157153"
"1194";"PV29  ";"1995JJ00";"155307";"2410";"2253";"157";"1885";"-39";"157153"
"1195";"PV29  ";"1996KW01";"157153";"281";"262";"19";"-22";"0";"157131"
"1196";"PV29  ";"1996KW02";"157131";"558";"458";"100";"500";"0";"157631"
"1197";"PV29  ";"1996KW03";"157631";"373";"355";"18";"313";"0";"157944"
"1198";"PV29  ";"1996KW04";"157944";"814";"709";"105";"743";"-40";"158647"
"1199";"PV29  ";"1996JJ00";"157153";"2026";"1784";"242";"1534";"-40";"158647"
"1200";"PV29  ";"1997KW01";"158647";"302";"295";"7";"287";"0";"158934"
"1201";"PV29  ";"1997KW02";"158934";"625";"588";"37";"408";"0";"159342"
"1202";"PV29  ";"1997KW03";"159342";"426";"413";"13";"405";"0";"159747"
"1203";"PV29  ";"1997KW04";"159747";"587";"559";"28";"447";"301";"160495"
"1204";"PV29  ";"1997JJ00";"158647";"1940";"1855";"85";"1547";"301";"160495"
"1205";"PV29  ";"1998KW01";"160495";"325";"309";"16";"122";"0";"160617"
"1206";"PV29  ";"1998KW02";"160617";"812";"637";"175";"619";"0";"161236"
"1207";"PV29  ";"1998KW03";"161236";"337";"294";"43";"275";"0";"161511"
"1208";"PV29  ";"1998KW04";"161511";"860";"804";"56";"781";"-367";"161925"
"1209";"PV29  ";"1998JJ00";"160495";"2334";"2044";"290";"1797";"-367";"161925"
"1210";"PV29  ";"1999KW01";"161925";"274";"270";"4";"214";"0";"162139"
"1211";"PV29  ";"1999KW02";"162139";"338";"326";"12";"197";"0";"162336"
"1212";"PV29  ";"1999KW03";"162336";"476";"439";"37";"429";"0";"162765"
"1213";"PV29  ";"1999KW04";"162765";"628";"600";"28";"493";"257";"163515"
"1214";"PV29  ";"1999JJ00";"161925";"1716";"1635";"81";"1333";"257";"163515"
"1215";"PV29  ";"2000KW01";"163515";"536";"492";"44";"457";"0";"163972"
"1216";"PV29  ";"2000KW02";"163972";"230";"226";"4";"169";"0";"164141"
"1217";"PV29  ";"2000KW03";"164141";"490";"481";"9";"449";"0";"164590"
"1218";"PV29  ";"2000KW04";"164590";"656";"646";"10";"58";"-189";"164459"
"1219";"PV29  ";"2000JJ00";"163515";"1912";"1845";"67";"1133";"-189";"164459"
"1220";"PV29  ";"2001KW01";"164459";"371";"363";"8";"309";"0";"164768"
"1221";"PV29  ";"2001KW02";"164768";"291";"280";"11";"267";"0";"165035"
"1222";"PV29  ";"2001KW03";"165035";"349";"339";"10";"237";"0";"165272"
"1223";"PV29  ";"2001KW04";"165272";"373";"361";"12";"298";"-185";"165385"
"1224";"PV29  ";"2001JJ00";"164459";"1384";"1343";"41";"1111";"-185";"165385"
"1225";"PV29  ";"2002KW01";"165385";"224";"222";"2";"159";"0";"165544"
"1226";"PV29  ";"2002KW02";"165544";"326";"319";"7";"157";"0";"165701"
"1227";"PV29  ";"2002KW03";"165701";"161";"149";"12";"126";"0";"165827"
"1228";"PV29  ";"2002KW04";"165827";"638";"613";"25";"433";"-56";"166204"
"1229";"PV29  ";"2002JJ00";"165385";"1349";"1303";"46";"875";"-56";"166204"
"1230";"PV29  ";"2003KW01";"166204";"171";"164";"7";"129";"0";"166333"
"1231";"PV29  ";"2003KW02";"166333";"213";"211";"2";"128";"0";"166461"
"1232";"PV29  ";"2003KW03";"166461";"144";"133";"11";"54";"0";"166515"
"1233";"PV29  ";"2003KW04";"166515";"544";"523";"21";"421";"-103";"166833"
"1234";"PV29  ";"2003JJ00";"166204";"1072";"1031";"41";"732";"-103";"166833"
"1235";"PV29  ";"2004KW01";"166833";"224";"218";"6";"168";"0";"167001"
"1236";"PV29  ";"2004KW02";"167001";"137";"133";"4";"112";"0";"167113"
"1237";"PV29  ";"2004KW03";"167113";"297";"289";"8";"222";"0";"167335"
"1238";"PV29  ";"2004KW04";"167335";"859";"845";"14";"746";"-79";"168002"
"1239";"PV29  ";"2004JJ00";"166833";"1517";"1485";"32";"1248";"-79";"168002"
"1240";"PV29  ";"2005KW01";"168002";"318";"314";"4";"289";"0";"168291"
"1241";"PV29  ";"2005KW02";"168291";"376";"359";"17";"352";"0";"168643"
"1242";"PV29  ";"2005KW03";"168643";"242";"235";"7";"191";"0";"168834"
"1243";"PV29  ";"2005KW04";"168834";"902";"768";"134";"824";"-27";"169631"
"1244";"PV29  ";"2005JJ00";"168002";"1838";"1676";"162";"1656";"-27";"169631"
"1245";"PV29  ";"2006KW01";"169631";"304";"284";"20";"240";"0";"169871"
"1246";"PV29  ";"2006KW02";"169871";"230";"220";"10";"194";"0";"170065"
"1247";"PV29  ";"2006KW03";"170065";"399";"350";"49";"280";"0";"170345"
"1248";"PV29  ";"2006KW04";"170345";"975";"832";"143";"681";"-163";"170863"
"1249";"PV29  ";"2006JJ00";"169631";"1908";"1686";"222";"1395";"-163";"170863"
"1250";"PV29  ";"2007KW01";"170863";"216";"211";"5";"196";"0";"171059"
"1251";"PV29  ";"2007KW02";"171059";"291";"275";"16";"277";"0";"171336"
"1252";"PV29  ";"2007KW03";"171336";"396";"345";"51";"248";"0";"171584"
"1253";"PV29  ";"2007KW04";"171584";"671";"658";"13";"626";"100";"172310"
"1254";"PV29  ";"2007JJ00";"170863";"1574";"1489";"85";"1347";"100";"172310"
"1255";"PV29  ";"2008KW01";"173073";"283";"245";"38";"267";"0";"173340"
"1256";"PV29  ";"2008KW02";"173340";"307";"296";"11";"279";"0";"173619"
"1257";"PV29  ";"2008KW03";"173619";"434";"416";"18";"383";"0";"174002"
"1258";"PV29  ";"2008KW04";"174002";"628";"613";"15";"576";"-83";"174495"
"1259";"PV29  ";"2008JJ00";"173073";"1652";"1570";"82";"1505";"-83";"174495"
"1260";"PV29  ";"2009KW01";"174495";"367";"340";"27";"289";"0";"174784"
"1261";"PV29  ";"2009KW02";"174784";"187";"173";"14";"116";"0";"174900"
"1262";"PV29  ";"2009KW03";"174900";"522";"466";"56";"481";"0";"175381"
"1263";"PV29  ";"2009KW04";"175381";"561";"509";"52";"509";"-41";"175849"
"1264";"PV29  ";"2009JJ00";"174495";"1637";"1488";"149";"1395";"-41";"175849"
"1265";"PV29  ";"2010KW01";"175849";"303";"266";"37";"237";"0";"176086"
"1266";"PV29  ";"2010KW02";"176086";"261";"235";"26";"146";"0";"176232"
"1267";"PV29  ";"2010KW03";"176232";"99";"80";"19";"38";"0";"176270"
"1268";"PV29  ";"2010KW04";"176270";"380";"373";"7";"247";"-29";"176488"
"1269";"PV29  ";"2010JJ00";"175849";"1043";"954";"89";"668";"-29";"176488"
"1270";"PV29  ";"2011KW01";"176488";"204";"178";"26";"137";"0";"176625"
"1271";"PV29  ";"2011KW02";"176625";"327";"315";"12";"266";"0";"176891"
"1272";"PV29  ";"2011KW03";"176891";"211";"198";"13";"178";"0";"177069"
"1273";"PV29  ";"2011KW04";"177069";"573";"560";"13";"535";"13";"177617"
"1274";"PV29  ";"2011JJ00";"176488";"1315";"1251";"64";"1116";"13";"177617"
"1275";"PV30  ";"1995KW01";"872758";"2531";"2424";"107";"2211";"0";"874969"
"1276";"PV30  ";"1995KW02";"874969";"3378";"3251";"127";"3058";"0";"878027"
"1277";"PV30  ";"1995KW03";"878027";"3914";"3801";"113";"3632";"0";"881659"
"1278";"PV30  ";"1995KW04";"881659";"5960";"5798";"162";"5389";"-361";"886686"
"1279";"PV30  ";"1995JJ00";"872758";"15783";"15274";"509";"14290";"-361";"886686"
"1280";"PV30  ";"1996KW01";"886686";"1827";"1770";"57";"1639";"0";"888325"
"1281";"PV30  ";"1996KW02";"888325";"2925";"2492";"433";"2507";"0";"890832"
"1282";"PV30  ";"1996KW03";"890832";"3374";"3237";"137";"2934";"0";"893766"
"1283";"PV30  ";"1996KW04";"893766";"6666";"6448";"218";"6262";"57";"900085"
"1284";"PV30  ";"1996JJ00";"886686";"14792";"13947";"845";"13342";"57";"900085"
"1285";"PV30  ";"1997KW01";"900085";"1541";"1484";"57";"1193";"0";"901278"
"1286";"PV30  ";"1997KW02";"901278";"3198";"3124";"74";"2936";"0";"904214"
"1287";"PV30  ";"1997KW03";"904214";"3257";"3205";"52";"3033";"0";"907247"
"1288";"PV30  ";"1997KW04";"907247";"6675";"6507";"168";"6203";"-425";"913025"
"1289";"PV30  ";"1997JJ00";"900085";"14671";"14320";"351";"13365";"-425";"913025"
"1290";"PV30  ";"1998KW01";"913025";"2235";"2125";"110";"2070";"0";"915095"
"1291";"PV30  ";"1998KW02";"915095";"2911";"2840";"71";"2596";"0";"917691"
"1292";"PV30  ";"1998KW03";"917691";"3178";"3089";"89";"3016";"0";"920707"
"1293";"PV30  ";"1998KW04";"920707";"7036";"6814";"222";"6650";"-267";"927090"
"1294";"PV30  ";"1998JJ00";"913025";"15360";"14868";"492";"14332";"-267";"927090"
"1295";"PV30  ";"1999KW01";"927090";"1219";"1124";"95";"934";"0";"928024"
"1296";"PV30  ";"1999KW02";"928024";"2690";"2586";"104";"2429";"0";"930453"
"1297";"PV30  ";"1999KW03";"930453";"2473";"2427";"46";"2296";"0";"932749"
"1298";"PV30  ";"1999KW04";"932749";"5771";"5598";"173";"5243";"505";"938497"
"1299";"PV30  ";"1999JJ00";"927090";"12153";"11735";"418";"10902";"505";"938497"
"1300";"PV30  ";"2000KW01";"938497";"1762";"1694";"68";"1624";"0";"940121"
"1301";"PV30  ";"2000KW02";"940121";"2375";"2312";"63";"2036";"0";"942157"
"1302";"PV30  ";"2000KW03";"942157";"2467";"2391";"76";"2275";"0";"944432"
"1303";"PV30  ";"2000KW04";"944432";"5188";"5044";"144";"4808";"-202";"949038"
"1304";"PV30  ";"2000JJ00";"938497";"11792";"11441";"351";"10743";"-202";"949038"
"1305";"PV30  ";"2001KW01";"949038";"1402";"1354";"48";"1110";"0";"950148"
"1306";"PV30  ";"2001KW02";"950148";"2135";"1987";"148";"1843";"0";"951991"
"1307";"PV30  ";"2001KW03";"951991";"1951";"1901";"50";"1844";"0";"953835"
"1308";"PV30  ";"2001KW04";"953835";"4488";"4316";"172";"3800";"-219";"957416"
"1309";"PV30  ";"2001JJ00";"949038";"9976";"9558";"418";"8597";"-219";"957416"
"1310";"PV30  ";"2002KW01";"957416";"1097";"1028";"69";"944";"0";"958360"
"1311";"PV30  ";"2002KW02";"958360";"1439";"1279";"160";"801";"0";"959161"
"1312";"PV30  ";"2002KW03";"959161";"1785";"1718";"67";"1610";"0";"960771"
"1313";"PV30  ";"2002KW04";"960771";"4079";"3914";"165";"3154";"-136";"963789"
"1314";"PV30  ";"2002JJ00";"957416";"8400";"7939";"461";"6509";"-136";"963789"
"1315";"PV30  ";"2003KW01";"963789";"822";"754";"68";"606";"0";"964395"
"1316";"PV30  ";"2003KW02";"964395";"1447";"1395";"52";"1214";"0";"965609"
"1317";"PV30  ";"2003KW03";"965609";"1367";"1327";"40";"1002";"0";"966611"
"1318";"PV30  ";"2003KW04";"966611";"3954";"3848";"106";"2846";"-25";"969432"
"1319";"PV30  ";"2003JJ00";"963789";"7590";"7324";"266";"5668";"-25";"969432"
"1320";"PV30  ";"2004KW01";"969432";"1192";"1049";"143";"400";"0";"969832"
"1321";"PV30  ";"2004KW02";"969832";"1856";"1679";"177";"1391";"0";"971223"
"1322";"PV30  ";"2004KW03";"971223";"1818";"1672";"146";"1458";"0";"972681"
"1323";"PV30  ";"2004KW04";"972681";"6504";"5879";"625";"5840";"-625";"977896"
"1324";"PV30  ";"2004JJ00";"969432";"11370";"10279";"1091";"9089";"-625";"977896"
"1325";"PV30  ";"2005KW01";"977896";"1088";"982";"106";"735";"0";"978631"
"1326";"PV30  ";"2005KW02";"978631";"1459";"1371";"88";"1173";"0";"979804"
"1327";"PV30  ";"2005KW03";"979804";"1475";"1429";"46";"1022";"0";"980826"
"1328";"PV30  ";"2005KW04";"980826";"4953";"4351";"602";"4092";"-161";"984757"
"1329";"PV30  ";"2005JJ00";"977896";"8975";"8133";"842";"7022";"-161";"984757"
"1330";"PV30  ";"2006KW01";"984757";"1468";"1314";"154";"991";"0";"985748"
"1331";"PV30  ";"2006KW02";"985748";"2457";"2380";"77";"2195";"0";"987943"
"1332";"PV30  ";"2006KW03";"987943";"2935";"2728";"207";"2533";"0";"990476"
"1333";"PV30  ";"2006KW04";"990476";"4755";"4503";"252";"3694";"-216";"993954"
"1334";"PV30  ";"2006JJ00";"984757";"11615";"10925";"690";"9413";"-216";"993954"
"1335";"PV30  ";"2007KW01";"993954";"1791";"1673";"118";"1052";"0";"995006"
"1336";"PV30  ";"2007KW02";"995006";"2418";"2296";"122";"2167";"0";"997173"
"1337";"PV30  ";"2007KW03";"997173";"2476";"2373";"103";"2046";"0";"999219"
"1338";"PV30  ";"2007KW04";"999219";"6108";"4965";"1143";"5313";"-525";"1004007"
"1339";"PV30  ";"2007JJ00";"993954";"12793";"11307";"1486";"10578";"-525";"1004007"
"1340";"PV30  ";"2008KW01";"1006145";"1309";"1251";"58";"640";"0";"1006785"
"1341";"PV30  ";"2008KW02";"1006785";"2551";"2325";"226";"1670";"0";"1008455"
"1342";"PV30  ";"2008KW03";"1008455";"3021";"2880";"141";"2237";"0";"1010692"
"1343";"PV30  ";"2008KW04";"1010692";"5062";"4701";"361";"4148";"-389";"1014451"
"1344";"PV30  ";"2008JJ00";"1006145";"11943";"11157";"786";"8695";"-389";"1014451"
"1345";"PV30  ";"2009KW01";"1014451";"1776";"1589";"187";"1507";"0";"1015958"
"1346";"PV30  ";"2009KW02";"1015958";"1926";"1793";"133";"1688";"0";"1017646"
"1347";"PV30  ";"2009KW03";"1017646";"3050";"2918";"132";"2782";"0";"1020428"
"1348";"PV30  ";"2009KW04";"1020428";"6990";"6555";"435";"6244";"-450";"1026222"
"1349";"PV30  ";"2009JJ00";"1014451";"13742";"12855";"887";"12221";"-450";"1026222"
"1350";"PV30  ";"2010KW01";"1026222";"882";"853";"29";"650";"0";"1026872"
"1351";"PV30  ";"2010KW02";"1026872";"2067";"1999";"68";"1759";"0";"1028631"
"1352";"PV30  ";"2010KW03";"1028631";"1702";"1664";"38";"1483";"0";"1030114"
"1353";"PV30  ";"2010KW04";"1030114";"4272";"3997";"275";"3379";"-70";"1033423"
"1354";"PV30  ";"2010JJ00";"1026222";"8923";"8513";"410";"7271";"-70";"1033423"
"1355";"PV30  ";"2011KW01";"1033423";"1852";"1722";"130";"1664";"0";"1035087"
"1356";"PV30  ";"2011KW02";"1035087";"1787";"1679";"108";"1366";"0";"1036453"
"1357";"PV30  ";"2011KW03";"1036453";"1494";"1396";"98";"984";"0";"1037437"
"1358";"PV30  ";"2011KW04";"1037437";"5395";"5070";"325";"4850";"-516";"1041769"
"1359";"PV30  ";"2011JJ00";"1033423";"10528";"9867";"661";"8864";"-516";"1041771"
"1360";"PV31  ";"1995KW01";"447356";"1130";"1007";"123";"1061";"0";"448417"
"1361";"PV31  ";"1995KW02";"448417";"1903";"1787";"116";"1852";"0";"450269"
"1362";"PV31  ";"1995KW03";"450269";"1302";"1032";"270";"1163";"0";"451432"
"1363";"PV31  ";"1995KW04";"451432";"2168";"1946";"222";"1927";"-5";"453352"
"1364";"PV31  ";"1995JJ00";"447356";"6503";"5772";"731";"6003";"-5";"453352"
"1365";"PV31  ";"1996KW01";"453352";"564";"531";"33";"511";"0";"453863"
"1366";"PV31  ";"1996KW02";"453863";"1376";"1122";"254";"1212";"0";"455075"
"1367";"PV31  ";"1996KW03";"455075";"1249";"1183";"66";"1111";"0";"456186"
"1368";"PV31  ";"1996KW04";"456186";"2346";"2234";"112";"2255";"-13";"458428"
"1369";"PV31  ";"1996JJ00";"453352";"5535";"5070";"465";"5089";"-13";"458428"
"1370";"PV31  ";"1997KW01";"458428";"1001";"904";"97";"941";"0";"459369"
"1371";"PV31  ";"1997KW02";"459369";"1736";"1663";"73";"1673";"0";"461042"
"1372";"PV31  ";"1997KW03";"461042";"1400";"1355";"45";"1340";"0";"462382"
"1373";"PV31  ";"1997KW04";"462382";"2458";"2258";"200";"2163";"-269";"464276"
"1374";"PV31  ";"1997JJ00";"458428";"6595";"6180";"415";"6117";"-269";"464276"
"1375";"PV31  ";"1998KW01";"464276";"699";"650";"49";"632";"0";"464908"
"1376";"PV31  ";"1998KW02";"464908";"1037";"936";"101";"949";"0";"465857"
"1377";"PV31  ";"1998KW03";"465857";"966";"905";"61";"906";"0";"466763"
"1378";"PV31  ";"1998KW04";"466763";"1789";"1634";"155";"1597";"946";"469306"
"1379";"PV31  ";"1998JJ00";"464276";"4491";"4125";"366";"4084";"946";"469306"
"1380";"PV31  ";"1999KW01";"469306";"513";"461";"52";"448";"0";"469754"
"1381";"PV31  ";"1999KW02";"469754";"1049";"1010";"39";"359";"0";"470113"
"1382";"PV31  ";"1999KW03";"470113";"946";"903";"43";"797";"0";"470910"
"1383";"PV31  ";"1999KW04";"470910";"1849";"1773";"76";"1713";"-256";"472367"
"1384";"PV31  ";"1999JJ00";"469306";"4357";"4147";"210";"3317";"-256";"472367"
"1385";"PV31  ";"2000KW01";"472367";"671";"641";"30";"611";"0";"472978"
"1386";"PV31  ";"2000KW02";"472978";"693";"641";"52";"609";"0";"473587"
"1387";"PV31  ";"2000KW03";"473587";"668";"614";"54";"611";"0";"474198"
"1388";"PV31  ";"2000KW04";"474198";"1867";"1756";"111";"1729";"-99";"475828"
"1389";"PV31  ";"2000JJ00";"472367";"3899";"3652";"247";"3560";"-99";"475828"
"1390";"PV31  ";"2001KW01";"475828";"701";"670";"31";"660";"0";"476488"
"1391";"PV31  ";"2001KW02";"476488";"798";"726";"72";"654";"0";"477142"
"1392";"PV31  ";"2001KW03";"477142";"879";"839";"40";"757";"0";"477899"
"1393";"PV31  ";"2001KW04";"477899";"1917";"1711";"206";"1513";"-282";"479130"
"1394";"PV31  ";"2001JJ00";"475828";"4295";"3946";"349";"3584";"-282";"479130"
"1395";"PV31  ";"2002KW01";"479130";"437";"425";"12";"377";"0";"479507"
"1396";"PV31  ";"2002KW02";"479507";"971";"932";"39";"599";"0";"480106"
"1397";"PV31  ";"2002KW03";"480106";"594";"532";"62";"564";"0";"480670"
"1398";"PV31  ";"2002KW04";"480670";"1798";"1631";"167";"1566";"-286";"481950"
"1399";"PV31  ";"2002JJ00";"479130";"3800";"3520";"280";"3106";"-286";"481950"
"1400";"PV31  ";"2003KW01";"481950";"559";"498";"61";"265";"0";"482215"
"1401";"PV31  ";"2003KW02";"482215";"597";"554";"43";"247";"0";"482462"
"1402";"PV31  ";"2003KW03";"482462";"345";"314";"31";"274";"0";"482736"
"1403";"PV31  ";"2003KW04";"482736";"1488";"1351";"137";"1251";"4";"483991"
"1404";"PV31  ";"2003JJ00";"481950";"2989";"2717";"272";"2037";"4";"483991"
"1405";"PV31  ";"2004KW01";"483991";"470";"364";"106";"307";"0";"484298"
"1406";"PV31  ";"2004KW02";"484298";"577";"529";"48";"403";"0";"484701"
"1407";"PV31  ";"2004KW03";"484701";"869";"813";"56";"622";"0";"485323"
"1408";"PV31  ";"2004KW04";"485323";"1674";"1558";"116";"1169";"-287";"486205"
"1409";"PV31  ";"2004JJ00";"483991";"3590";"3264";"326";"2501";"-287";"486205"
"1410";"PV31  ";"2005KW01";"486205";"704";"616";"88";"553";"0";"486758"
"1411";"PV31  ";"2005KW02";"486758";"862";"743";"119";"753";"0";"487511"
"1412";"PV31  ";"2005KW03";"487511";"513";"404";"109";"361";"0";"487872"
"1413";"PV31  ";"2005KW04";"487872";"1831";"1687";"144";"1491";"-133";"489230"
"1414";"PV31  ";"2005JJ00";"486205";"3910";"3450";"460";"3158";"-133";"489230"
"1415";"PV31  ";"2006KW01";"489230";"799";"744";"55";"731";"0";"489961"
"1416";"PV31  ";"2006KW02";"489961";"1065";"570";"495";"731";"0";"490692"
"1417";"PV31  ";"2006KW03";"490692";"923";"646";"277";"718";"0";"491410"
"1418";"PV31  ";"2006KW04";"491410";"1878";"1705";"173";"1618";"-118";"492910"
"1419";"PV31  ";"2006JJ00";"489230";"4665";"3665";"1000";"3798";"-118";"492910"
"1420";"PV31  ";"2007KW01";"492910";"245";"178";"67";"91";"0";"493001"
"1421";"PV31  ";"2007KW02";"493001";"1007";"965";"42";"625";"0";"493626"
"1422";"PV31  ";"2007KW03";"493626";"1753";"1683";"70";"1389";"0";"495015"
"1423";"PV31  ";"2007KW04";"495015";"1889";"1781";"108";"1555";"-810";"495760"
"1424";"PV31  ";"2007JJ00";"492910";"4894";"4607";"287";"3660";"-810";"495760"
"1425";"PV31  ";"2008KW01";"497586";"762";"561";"201";"31";"0";"497617"
"1426";"PV31  ";"2008KW02";"497617";"636";"515";"121";"236";"0";"497853"
"1427";"PV31  ";"2008KW03";"497853";"1003";"947";"56";"919";"0";"498772"
"1428";"PV31  ";"2008KW04";"498772";"1525";"1403";"122";"1029";"-37";"499764"
"1429";"PV31  ";"2008JJ00";"497586";"3926";"3426";"500";"2215";"-37";"499764"
"1430";"PV31  ";"2009KW01";"499764";"902";"808";"94";"587";"0";"500351"
"1431";"PV31  ";"2009KW02";"500351";"430";"385";"45";"248";"0";"500599"
"1432";"PV31  ";"2009KW03";"500599";"837";"758";"79";"685";"0";"501284"
"1433";"PV31  ";"2009KW04";"501284";"2014";"1880";"134";"1600";"-156";"502728"
"1434";"PV31  ";"2009JJ00";"499764";"4183";"3831";"352";"3120";"-156";"502728"
"1435";"PV31  ";"2010KW01";"502728";"385";"317";"68";"232";"0";"502960"
"1436";"PV31  ";"2010KW02";"502960";"308";"277";"31";"225";"0";"503185"
"1437";"PV31  ";"2010KW03";"503185";"955";"841";"114";"684";"0";"503869"
"1438";"PV31  ";"2010KW04";"503869";"2076";"1883";"193";"1541";"69";"505479"
"1439";"PV31  ";"2010JJ00";"502728";"3724";"3318";"406";"2682";"69";"505479"
"1440";"PV31  ";"2011KW01";"505479";"187";"159";"28";"88";"0";"505567"
"1441";"PV31  ";"2011KW02";"505567";"369";"292";"77";"300";"0";"505867"
"1442";"PV31  ";"2011KW03";"505867";"634";"574";"60";"495";"0";"506362"
"1443";"PV31  ";"2011KW04";"506362";"1853";"1637";"216";"1486";"-203";"507646"
"1444";"PV31  ";"2011JJ00";"505479";"3043";"2662";"381";"2369";"-203";"507645"
